"codigo_municipio","nome_municipio","regiao","estado","area_km2","total_pessoas","total_domicilios","tot_domicilios_particulares","tot_domicilios_coletivos","media_moradores_domicilios_ocupados"
1100015,"ALTA FLORESTA D'OESTE","NORTE","RONDÔNIA","7067.1267819",21494,10081,10062,19,"2.8"
1100023,"ARIQUEMES","NORTE","RONDÔNIA","4426.1431256",96833,44157,44114,43,"2.8"
1100031,"CABIXI","NORTE","RONDÔNIA","1314.3518453",5351,2927,2921,6,"2.7"
1100049,"CACOAL","NORTE","RONDÔNIA","3792.9997067",86887,40930,40905,25,"2.7"
1100056,"CEREJEIRAS","NORTE","RONDÔNIA","2783.2970407",15890,7069,7064,5,"2.7"
1100064,"COLORADO DO OESTE","NORTE","RONDÔNIA","1451.0627783",15663,8150,8146,4,"2.6"
1100072,"CORUMBIARA","NORTE","RONDÔNIA","3060.3214759",7519,3960,3920,40,"2.6"
1100080,"COSTA MARQUES","NORTE","RONDÔNIA","4987.1766339",12627,5854,5841,13,"3"
1100098,"ESPIGÃO D'OESTE","NORTE","RONDÔNIA","4518.0378105",29414,13173,13158,15,"2.8"
1100106,"GUAJARÁ-MIRIM","NORTE","RONDÔNIA","24856.8768949",39387,15954,15922,32,"3.3"
1100114,"JARU","NORTE","RONDÔNIA","2944.1396619",50591,24078,24068,10,"2.7"
1100122,"JI-PARANÁ","NORTE","RONDÔNIA","6896.6486985",124333,56566,56511,55,"2.7"
1100130,"MACHADINHO D'OESTE","NORTE","RONDÔNIA","8509.2698595",30707,15087,15073,14,"2.8"
1100148,"NOVA BRASILÂNDIA D'OESTE","NORTE","RONDÔNIA","1703.0075289",15679,7861,7859,2,"2.7"
1100155,"OURO PRETO DO OESTE","NORTE","RONDÔNIA","1969.8789181",35044,16423,16403,20,"2.6"
1100189,"PIMENTA BUENO","NORTE","RONDÔNIA","6241.0191621",35079,16464,16442,22,"2.8"
1100205,"PORTO VELHO","NORTE","RONDÔNIA","34091.1456343",460434,203556,203336,220,"3"
1100254,"PRESIDENTE MÉDICI","NORTE","RONDÔNIA","1758.4644205",19327,9484,9469,15,"2.7"
1100262,"RIO CRESPO","NORTE","RONDÔNIA","1717.6403518",3471,1772,1766,6,"2.8"
1100288,"ROLIM DE MOURA","NORTE","RONDÔNIA","1457.8115503",56406,25631,25604,27,"2.7"
1100296,"SANTA LUZIA D'OESTE","NORTE","RONDÔNIA","1197.7958146",7419,3580,3571,9,"2.7"
1100304,"VILHENA","NORTE","RONDÔNIA","11708.5793655",95832,42599,42575,24,"2.7"
1100320,"SÃO MIGUEL DO GUAPORÉ","NORTE","RONDÔNIA","7460.1174122",21635,10321,10313,8,"2.7"
1100338,"NOVA MAMORÉ","NORTE","RONDÔNIA","10070.4901361",25444,12082,12058,24,"3"
1100346,"ALVORADA D'OESTE","NORTE","RONDÔNIA","3029.18928",13117,6206,6204,2,"2.7"
1100379,"ALTO ALEGRE DOS PARECIS","NORTE","RONDÔNIA","3958.2730884",11479,5188,5179,9,"2.8"
1100403,"ALTO PARAÍSO","NORTE","RONDÔNIA","2651.9910802",16320,7563,7555,8,"2.8"
1100452,"BURITIS","NORTE","RONDÔNIA","3265.810053",27992,13246,13232,14,"2.8"
1100502,"NOVO HORIZONTE DO OESTE","NORTE","RONDÔNIA","843.4464418",7667,3961,3955,6,"2.7"
1100601,"CACAULÂNDIA","NORTE","RONDÔNIA","1962.0260009",4150,2274,2270,4,"2.8"
1100700,"CAMPO NOVO DE RONDÔNIA","NORTE","RONDÔNIA","3442.0046221",8844,4820,4817,3,"2.9"
1100809,"CANDEIAS DO JAMARI","NORTE","RONDÔNIA","6843.6728394",22310,10983,10974,9,"3"
1100908,"CASTANHEIRAS","NORTE","RONDÔNIA","892.8408641",3233,1753,1748,5,"2.7"
1100924,"CHUPINGUAIA","NORTE","RONDÔNIA","5117.2901748",9324,4250,4209,41,"2.9"
1100940,"CUJUBIM","NORTE","RONDÔNIA","3863.9457876",14863,7604,7586,18,"2.8"
1101005,"GOVERNADOR JORGE TEIXEIRA","NORTE","RONDÔNIA","5067.3842264",8001,4039,4036,3,"2.8"
1101104,"ITAPUÃ DO OESTE","NORTE","RONDÔNIA","4081.5808298",8548,4116,4109,7,"2.9"
1101203,"MINISTRO ANDREAZZA","NORTE","RONDÔNIA","798.082745",6466,3412,3412,0,"2.7"
1101302,"MIRANTE DA SERRA","NORTE","RONDÔNIA","1191.875016",9235,5002,4998,4,"2.6"
1101401,"MONTE NEGRO","NORTE","RONDÔNIA","1931.3781226",11548,5927,5921,6,"2.7"
1101435,"NOVA UNIÃO","NORTE","RONDÔNIA","807.139758",6200,2885,2882,3,"2.8"
1101450,"PARECIS","NORTE","RONDÔNIA","2548.6827671",4125,2384,2377,7,"2.8"
1101468,"PIMENTEIRAS DO OESTE","NORTE","RONDÔNIA","6014.7333666",2156,1239,1216,23,"2.9"
1101476,"PRIMAVERA DE RONDÔNIA","NORTE","RONDÔNIA","605.692099",3076,1500,1500,0,"2.7"
1101484,"SÃO FELIPE D'OESTE","NORTE","RONDÔNIA","541.6466345",5258,2423,2422,1,"2.7"
1101492,"SÃO FRANCISCO DO GUAPORÉ","NORTE","RONDÔNIA","10948.5925608",16286,7562,7549,13,"2.8"
1101500,"SERINGUEIRAS","NORTE","RONDÔNIA","3773.5047171",11171,5190,5181,9,"2.8"
1101559,"TEIXEIRÓPOLIS","NORTE","RONDÔNIA","459.934975",4256,2031,2031,0,"2.7"
1101609,"THEOBROMA","NORTE","RONDÔNIA","2197.4127164",8113,4385,4378,7,"2.7"
1101708,"URUPÁ","NORTE","RONDÔNIA","831.8565258",10725,5041,5038,3,"2.7"
1101757,"VALE DO ANARI","NORTE","RONDÔNIA","3135.1055592",7788,3914,3912,2,"2.8"
1101807,"VALE DO PARAÍSO","NORTE","RONDÔNIA","965.6760389",6479,3453,3452,1,"2.6"
1200013,"ACRELÂNDIA","NORTE","ACRE","1811.6211974",14021,5708,5700,8,"3.1"
1200054,"ASSIS BRASIL","NORTE","ACRE","4977.8146767",8100,3002,2994,8,"3.3"
1200104,"BRASILÉIA","NORTE","ACRE","3928.8201969",26000,10946,10938,8,"3"
1200138,"BUJARI","NORTE","ACRE","3035.5465316",12917,5845,5832,13,"3.1"
1200179,"CAPIXABA","NORTE","ACRE","1705.2362394",10392,4222,4211,11,"3"
1200203,"CRUZEIRO DO SUL","NORTE","ACRE","8782.9221495",91888,31869,31828,41,"3.4"
1200252,"EPITACIOLÂNDIA","NORTE","ACRE","1652.7145404",18757,8125,8113,12,"2.9"
1200302,"FEIJÓ","NORTE","ACRE","27977.1202002",35426,11467,11422,45,"3.8"
1200328,"JORDÃO","NORTE","ACRE","5356.9805121",9222,2459,2450,9,"4.6"
1200336,"MÂNCIO LIMA","NORTE","ACRE","5451.6174617",19294,7067,7059,8,"3.4"
1200344,"MANOEL URBANO","NORTE","ACRE","10630.2248518",11996,4010,4004,6,"3.7"
1200351,"MARECHAL THAUMATURGO","NORTE","ACRE","8190.9668263",17093,5321,5313,8,"4"
1200385,"PLÁCIDO DE CASTRO","NORTE","ACRE","1952.5313998",16560,7245,7233,12,"3"
1200393,"PORTO WALTER","NORTE","ACRE","6446.1017078",10735,3279,3278,1,"4.1"
1200401,"RIO BRANCO","NORTE","ACRE","8834.8306355",364756,148826,148730,96,"2.9"
1200427,"RODRIGUES ALVES","NORTE","ACRE","3077.1586799",14938,5353,5348,5,"3.6"
1200435,"SANTA ROSA DO PURUS","NORTE","ACRE","6155.6593025",6723,1610,1608,2,"5"
1200450,"SENADOR GUIOMARD","NORTE","ACRE","2320.9458289",21454,9223,9212,11,"3"
1200500,"SENA MADUREIRA","NORTE","ACRE","23760.4102749",41343,14886,14859,27,"3.2"
1200609,"TARAUACÁ","NORTE","ACRE","20169.4846963",43467,13618,13606,12,"3.8"
1200708,"XAPURI","NORTE","ACRE","5350.299954",18243,7967,7945,22,"3"
1200807,"PORTO ACRE","NORTE","ACRE","2603.9420158",16693,7273,7259,14,"3.1"
1300029,"ALVARÃES","NORTE","AMAZONAS","5922.8838812",15866,4093,4072,21,"4.7"
1300060,"AMATURÁ","NORTE","AMAZONAS","4754.1093814",10819,2617,2612,5,"5"
1300086,"ANAMÃ","NORTE","AMAZONAS","2446.1205412",9962,2872,2862,10,"4.3"
1300102,"ANORI","NORTE","AMAZONAS","6036.0187462",17194,4798,4777,21,"4.1"
1300144,"APUÍ","NORTE","AMAZONAS","54240.5444181",20647,6706,6683,23,"3.5"
1300201,"ATALAIA DO NORTE","NORTE","AMAZONAS","76507.6168037",15314,3982,3938,44,"4.5"
1300300,"AUTAZES","NORTE","AMAZONAS","7652.851614",41564,15544,15523,21,"3.8"
1300409,"BARCELOS","NORTE","AMAZONAS","122462.653002",18834,5446,5415,31,"4.4"
1300508,"BARREIRINHA","NORTE","AMAZONAS","5751.764594",31051,9122,9078,44,"4.5"
1300607,"BENJAMIN CONSTANT","NORTE","AMAZONAS","8705.2650518",37648,9094,9056,38,"4.8"
1300631,"BERURI","NORTE","AMAZONAS","17472.7794597",20718,6049,6038,11,"4.5"
1300680,"BOA VISTA DO RAMOS","NORTE","AMAZONAS","2589.4071084",23785,4853,4838,15,"5.2"
1300706,"BOCA DO ACRE","NORTE","AMAZONAS","21938.5830727",35447,12654,12630,24,"3.5"
1300805,"BORBA","NORTE","AMAZONAS","44236.1836874",33080,10328,10312,16,"4.1"
1300839,"CAAPIRANGA","NORTE","AMAZONAS","9455.5394439",13469,3207,3192,15,"4.5"
1300904,"CANUTAMA","NORTE","AMAZONAS","33642.7315614",16869,5877,5871,6,"3.7"
1301001,"CARAUARI","NORTE","AMAZONAS","25778.6577227",28742,8205,8177,28,"4"
1301100,"CAREIRO","NORTE","AMAZONAS","6096.2118488",30792,13420,13391,29,"3.4"
1301159,"CAREIRO DA VÁRZEA","NORTE","AMAZONAS","2627.4744976",19637,7726,7710,16,"3.4"
1301209,"COARI","NORTE","AMAZONAS","57970.7844982",70616,21305,21266,39,"4"
1301308,"CODAJÁS","NORTE","AMAZONAS","18701.0735652",23549,6655,6634,21,"4.2"
1301407,"EIRUNEPÉ","NORTE","AMAZONAS","14966.241495",33170,9680,9667,13,"4.1"
1301506,"ENVIRA","NORTE","AMAZONAS","7505.7937305",17186,4877,4852,25,"4.1"
1301605,"FONTE BOA","NORTE","AMAZONAS","12156.0335894",25871,6053,6021,32,"4.8"
1301654,"GUAJARÁ","NORTE","AMAZONAS","7583.5341151",13815,4424,4417,7,"3.8"
1301704,"HUMAITÁ","NORTE","AMAZONAS","33111.1288271",57473,16571,16542,29,"4"
1301803,"IPIXUNA","NORTE","AMAZONAS","12109.7789981",24311,5149,5125,24,"5"
1301852,"IRANDUBA","NORTE","AMAZONAS","2216.8170152",61163,29204,29185,19,"3.4"
1301902,"ITACOATIARA","NORTE","AMAZONAS","8891.978697",103598,35124,35079,45,"3.7"
1301951,"ITAMARATI","NORTE","AMAZONAS","25260.4294781",10937,2819,2807,12,"4.7"
1302009,"ITAPIRANGA","NORTE","AMAZONAS","4335.0745413",10162,3429,3396,33,"3.9"
1302108,"JAPURÁ","NORTE","AMAZONAS","55827.2022745",8858,2188,2164,24,"5"
1302207,"JURUÁ","NORTE","AMAZONAS","19438.8046735",10742,3248,3233,15,"4.2"
1302306,"JUTAÍ","NORTE","AMAZONAS","69459.5008442",25172,5589,5563,26,"5.2"
1302405,"LÁBREA","NORTE","AMAZONAS","68262.6800857",45448,13474,13443,31,"4"
1302504,"MANACAPURU","NORTE","AMAZONAS","7336.5783542",101883,34985,34933,52,"3.8"
1302553,"MANAQUIRI","NORTE","AMAZONAS","3973.2576518",17107,6877,6873,4,"3.4"
1302603,"MANAUS","NORTE","AMAZONAS","11401.0017014",2063689,738012,737542,470,"3.3"
1302702,"MANICORÉ","NORTE","AMAZONAS","48315.0377159",53914,14248,14215,33,"4.4"
1302801,"MARAÃ","NORTE","AMAZONAS","16830.8261077",15529,3853,3815,38,"5.1"
1302900,"MAUÉS","NORTE","AMAZONAS","39991.0669352",61204,15847,15804,43,"4.6"
1303007,"NHAMUNDÁ","NORTE","AMAZONAS","14107.5017241",20136,5497,5491,6,"4.4"
1303106,"NOVA OLINDA DO NORTE","NORTE","AMAZONAS","5578.1320133",27062,8398,8386,12,"4.2"
1303205,"NOVO AIRÃO","NORTE","AMAZONAS","37776.6644922",15761,5291,5273,18,"3.8"
1303304,"NOVO ARIPUANÃ","NORTE","AMAZONAS","41179.6558658",23818,5583,5540,43,"4.9"
1303403,"PARINTINS","NORTE","AMAZONAS","5956.0475727",96372,29973,29893,80,"4"
1303502,"PAUINI","NORTE","AMAZONAS","41624.6641367",19373,4740,4714,26,"4.9"
1303536,"PRESIDENTE FIGUEIREDO","NORTE","AMAZONAS","25459.0991487",30668,15148,15127,21,"3.3"
1303569,"RIO PRETO DA EVA","NORTE","AMAZONAS","5815.6218018",24936,12804,12784,20,"3.2"
1303601,"SANTA ISABEL DO RIO NEGRO","NORTE","AMAZONAS","62798.8450739",14164,3328,3299,29,"5.1"
1303700,"SANTO ANTÔNIO DO IÇÁ","NORTE","AMAZONAS","12366.2147777",28211,6289,6263,26,"5.4"
1303809,"SÃO GABRIEL DA CACHOEIRA","NORTE","AMAZONAS","109192.593289",51795,13579,13520,59,"4.8"
1303908,"SÃO PAULO DE OLIVENÇA","NORTE","AMAZONAS","19658.5358838",32967,6845,6818,27,"5.5"
1303957,"SÃO SEBASTIÃO DO UATUMÃ","NORTE","AMAZONAS","10647.4632465",11670,3237,3224,13,"4.3"
1304005,"SILVES","NORTE","AMAZONAS","3723.3822083",11559,3923,3895,28,"4.1"
1304062,"TABATINGA","NORTE","AMAZONAS","3260.2451729",66764,17096,17047,49,"4.8"
1304104,"TAPAUÁ","NORTE","AMAZONAS","84946.0348044",19599,5983,5953,30,"4.1"
1304203,"TEFÉ","NORTE","AMAZONAS","23692.6208525",73669,21101,21071,30,"4.2"
1304237,"TONANTINS","NORTE","AMAZONAS","6447.2267077",19247,3848,3838,10,"5.7"
1304260,"UARINI","NORTE","AMAZONAS","10275.5586452",14431,3830,3799,31,"4.7"
1304302,"URUCARÁ","NORTE","AMAZONAS","27924.5661734",18631,5090,5070,20,"4.3"
1304401,"URUCURITUBA","NORTE","AMAZONAS","2863.8893945",23945,5619,5592,27,"4.5"
1400027,"AMAJARI","NORTE","RORAIMA","28473.4497513",13927,4066,4042,24,"4.6"
1400050,"ALTO ALEGRE","NORTE","RORAIMA","25454.297421",21096,6943,6937,6,"4.2"
1400100,"BOA VISTA","NORTE","RORAIMA","5687.0372998",413486,133020,132868,152,"3.4"
1400159,"BONFIM","NORTE","RORAIMA","8079.913916",13923,5245,5231,14,"4"
1400175,"CANTÁ","NORTE","RORAIMA","7664.8311993",18682,8597,8589,8,"3.4"
1400209,"CARACARAÍ","NORTE","RORAIMA","47379.6882374",20957,8631,8608,23,"3.4"
1400233,"CAROEBE","NORTE","RORAIMA","12065.8963865",10656,4059,4042,17,"3.4"
1400282,"IRACEMA","NORTE","RORAIMA","14011.6951132",10023,3727,3726,1,"3.4"
1400308,"MUCAJAÍ","NORTE","RORAIMA","12337.8510812",18095,7056,7030,26,"3.4"
1400407,"NORMANDIA","NORTE","RORAIMA","6959.8684566",13986,3569,3560,9,"5.1"
1400456,"PACARAIMA","NORTE","RORAIMA","8025.0445413",19305,5087,5058,29,"4.4"
1400472,"RORAINÓPOLIS","NORTE","RORAIMA","33579.7388368",32647,13107,13073,34,"3.2"
1400506,"SÃO JOÃO DA BALIZA","NORTE","RORAIMA","4284.5050289",8858,2864,2845,19,"3.3"
1400605,"SÃO LUIZ","NORTE","RORAIMA","1526.8984847",7315,2591,2576,15,"3.2"
1400704,"UIRAMUTÃ","NORTE","RORAIMA","8113.598503",13751,3403,3391,12,"5.8"
1500107,"ABAETETUBA","NORTE","PARÁ","1610.6458175",158188,51416,51353,63,"3.7"
1500131,"ABEL FIGUEIREDO","NORTE","PARÁ","614.1311459",6136,2583,2580,3,"3.1"
1500206,"ACARÁ","NORTE","PARÁ","4344.3871283",59023,21771,21742,29,"3.5"
1500305,"AFUÁ","NORTE","PARÁ","8338.4392535",37765,11041,11009,32,"4.2"
1500347,"ÁGUA AZUL DO NORTE","NORTE","PARÁ","7113.9560775",18080,6694,6679,15,"3.2"
1500404,"ALENQUER","NORTE","PARÁ","23644.3854659",69377,21957,21937,20,"3.9"
1500503,"ALMEIRIM","NORTE","PARÁ","72956.1726271",34280,12665,12625,40,"3.7"
1500602,"ALTAMIRA","NORTE","PARÁ","159533.3063087",126279,54274,54165,109,"3.1"
1500701,"ANAJÁS","NORTE","PARÁ","6913.6399885",28011,7665,7646,19,"4.4"
1500800,"ANANINDEUA","NORTE","PARÁ","190.5900783",478778,187386,187331,55,"3.1"
1500859,"ANAPU","NORTE","PARÁ","11895.2700287",31850,13000,12958,42,"3.4"
1500909,"AUGUSTO CORRÊA","NORTE","PARÁ","1099.5797115",44573,13983,13976,7,"3.6"
1500958,"AURORA DO PARÁ","NORTE","PARÁ","1811.8400624",23774,8261,8258,3,"3.6"
1501006,"AVEIRO","NORTE","PARÁ","17074.0528192",18290,6499,6470,29,"3.9"
1501105,"BAGRE","NORTE","PARÁ","4397.321327",31892,6489,6462,27,"5.5"
1501204,"BAIÃO","NORTE","PARÁ","3760.0004431",51641,13603,13530,73,"4.2"
1501253,"BANNACH","NORTE","PARÁ","2956.648748",4031,1894,1855,39,"3"
1501303,"BARCARENA","NORTE","PARÁ","1310.3375278",126650,48232,48174,58,"3.3"
1501402,"BELÉM","NORTE","PARÁ","1059.4577293",1303403,528989,528686,303,"3.1"
1501451,"BELTERRA","NORTE","PARÁ","4398.4181687",18099,7597,7585,12,"3.4"
1501501,"BENEVIDES","NORTE","PARÁ","187.8261324",63567,26334,26304,30,"3.1"
1501576,"BOM JESUS DO TOCANTINS","NORTE","PARÁ","2816.6043013",18005,5813,5795,18,"3.5"
1501600,"BONITO","NORTE","PARÁ","586.9767638",12622,5312,5311,1,"3"
1501709,"BRAGANÇA","NORTE","PARÁ","2124.7349094",123082,44053,44026,27,"3.3"
1501725,"BRASIL NOVO","NORTE","PARÁ","6362.5751329",24718,8945,8943,2,"3.4"
1501758,"BREJO GRANDE DO ARAGUAIA","NORTE","PARÁ","1288.4729414",6783,2963,2963,0,"3.2"
1501782,"BREU BRANCO","NORTE","PARÁ","3941.7362126",45712,16756,16744,12,"3.4"
1501808,"BREVES","NORTE","PARÁ","9566.4981201",106968,28115,28036,79,"4.4"
1501907,"BUJARU","NORTE","PARÁ","994.6624533",24383,8916,8906,10,"3.4"
1501956,"CACHOEIRA DO PIRIÁ","NORTE","PARÁ","2419.6000135",19630,7239,7233,6,"3.5"
1502004,"CACHOEIRA DO ARARI","NORTE","PARÁ","3100.2613422",23981,7320,7310,10,"3.7"
1502103,"CAMETÁ","NORTE","PARÁ","3082.1900775",134184,39905,39864,41,"4"
1502152,"CANAÃ DOS CARAJÁS","NORTE","PARÁ","3146.7485023",77079,28605,28514,91,"3.2"
1502202,"CAPANEMA","NORTE","PARÁ","621.4827885",70394,27668,27633,35,"3"
1502301,"CAPITÃO POÇO","NORTE","PARÁ","2901.0258381",56506,23019,22990,29,"3.1"
1502400,"CASTANHAL","NORTE","PARÁ","1029.2998035",192256,80009,79974,35,"3"
1502509,"CHAVES","NORTE","PARÁ","12534.9948658",20757,5818,5794,24,"4.4"
1502608,"COLARES","NORTE","PARÁ","384.0678842",12868,5678,5664,14,"3.2"
1502707,"CONCEIÇÃO DO ARAGUAIA","NORTE","PARÁ","5829.4819979",44617,19636,19569,67,"2.9"
1502756,"CONCÓRDIA DO PARÁ","NORTE","PARÁ","700.6141333",26881,9660,9656,4,"3.4"
1502764,"CUMARU DO NORTE","NORTE","PARÁ","17085.0005514",14036,5101,4863,238,"3.6"
1502772,"CURIONÓPOLIS","NORTE","PARÁ","2369.0963404",19950,9067,9033,34,"3.1"
1502806,"CURRALINHO","NORTE","PARÁ","3617.3502963",33903,9649,9627,22,"4.1"
1502855,"CURUÁ","NORTE","PARÁ","1431.3507343",14117,5183,5173,10,"3.6"
1502905,"CURUÇÁ","NORTE","PARÁ","676.3216933",41262,15589,15562,27,"3.4"
1502939,"DOM ELISEU","NORTE","PARÁ","5268.8085755",58484,16018,15990,28,"3.8"
1502954,"ELDORADO DO CARAJÁS","NORTE","PARÁ","2956.6914362",28192,12326,12314,12,"3.2"
1503002,"FARO","NORTE","PARÁ","11771.6690716",8728,2667,2658,9,"4.1"
1503044,"FLORESTA DO ARAGUAIA","NORTE","PARÁ","3444.2847799",17898,8732,8729,3,"3"
1503077,"GARRAFÃO DO NORTE","NORTE","PARÁ","1608.0143944",24703,9944,9939,5,"3.2"
1503093,"GOIANÉSIA DO PARÁ","NORTE","PARÁ","7023.9320683",26362,10964,10952,12,"3.2"
1503101,"GURUPÁ","NORTE","PARÁ","8569.6761531",31786,8645,8612,33,"4.3"
1503200,"IGARAPÉ-AÇU","NORTE","PARÁ","785.9827708",35797,14608,14595,13,"3.1"
1503309,"IGARAPÉ-MIRI","NORTE","PARÁ","1996.7979413",64831,19842,19830,12,"3.8"
1503408,"INHANGAPI","NORTE","PARÁ","472.6048694",10325,4068,4067,1,"3.2"
1503457,"IPIXUNA DO PARÁ","NORTE","PARÁ","5215.5553135",30329,11017,10990,27,"3.5"
1503507,"IRITUIA","NORTE","PARÁ","1385.2089234",30955,11840,11832,8,"3.2"
1503606,"ITAITUBA","NORTE","PARÁ","62042.4720058",123314,46002,45806,196,"3.4"
1503705,"ITUPIRANGA","NORTE","PARÁ","7880.2957961",49754,17966,17894,72,"3.6"
1503754,"JACAREACANGA","NORTE","PARÁ","53304.5626901",24042,6871,6793,78,"4.7"
1503804,"JACUNDÁ","NORTE","PARÁ","2008.3328798",37707,15759,15743,16,"3"
1503903,"JURUTI","NORTE","PARÁ","8306.2404319",50881,16369,16278,91,"4.1"
1504000,"LIMOEIRO DO AJURU","NORTE","PARÁ","1489.3558433",29569,8284,8273,11,"4.1"
1504059,"MÃE DO RIO","NORTE","PARÁ","469.340884",34353,11584,11583,1,"3.5"
1504109,"MAGALHÃES BARATA","NORTE","PARÁ","323.9835417",8115,3320,3312,8,"3.2"
1504208,"MARABÁ","NORTE","PARÁ","15127.8723222",266533,106660,106555,105,"3.1"
1504307,"MARACANÃ","NORTE","PARÁ","807.6280928",25971,10466,10401,65,"3.4"
1504406,"MARAPANIM","NORTE","PARÁ","804.6251122",26573,14439,14387,52,"3.2"
1504422,"MARITUBA","NORTE","PARÁ","103.2136504",111785,45933,45907,26,"3.1"
1504455,"MEDICILÂNDIA","NORTE","PARÁ","8272.6287234",27094,12394,12381,13,"3"
1504505,"MELGAÇO","NORTE","PARÁ","6772.7642694",27881,6244,6176,68,"4.8"
1504604,"MOCAJUBA","NORTE","PARÁ","871.1679479",27198,8411,8399,12,"4"
1504703,"MOJU","NORTE","PARÁ","9094.1389873",84094,30029,29940,89,"3.4"
1504752,"MOJUÍ DOS CAMPOS","NORTE","PARÁ","4988.2362763",23501,9912,9910,2,"3.1"
1504802,"MONTE ALEGRE","NORTE","PARÁ","18151.3233699",60012,24608,24592,16,"3.3"
1504901,"MUANÁ","NORTE","PARÁ","3763.3429145",45368,12700,12672,28,"4.2"
1504950,"NOVA ESPERANÇA DO PIRIÁ","NORTE","PARÁ","2808.1950502",20478,7914,7904,10,"3.4"
1504976,"NOVA IPIXUNA","NORTE","PARÁ","1564.1838046",13955,6156,6152,4,"3"
1505007,"NOVA TIMBOTEUA","NORTE","PARÁ","489.85223",12806,5741,5737,4,"2.8"
1505031,"NOVO PROGRESSO","NORTE","PARÁ","38162.0025349",33638,13888,13792,96,"3.2"
1505064,"NOVO REPARTIMENTO","NORTE","PARÁ","15398.7355614",60732,26251,26203,48,"3.3"
1505106,"ÓBIDOS","NORTE","PARÁ","28010.0006247",52229,19117,19094,23,"3.6"
1505205,"OEIRAS DO PARÁ","NORTE","PARÁ","3852.2906251",33844,9863,9815,48,"4.2"
1505304,"ORIXIMINÁ","NORTE","PARÁ","107613.6292521",68294,22520,22334,186,"3.8"
1505403,"OURÉM","NORTE","PARÁ","561.7097397",17855,7077,7075,2,"3.1"
1505437,"OURILÂNDIA DO NORTE","NORTE","PARÁ","14410.5665781",32467,13444,13418,26,"3.1"
1505486,"PACAJÁ","NORTE","PARÁ","11832.3228504",41097,17538,17502,36,"3.3"
1505494,"PALESTINA DO PARÁ","NORTE","PARÁ","984.3621892",6885,2951,2949,2,"3.1"
1505502,"PARAGOMINAS","NORTE","PARÁ","19342.5649087",105550,38234,38166,68,"3.2"
1505536,"PARAUAPEBAS","NORTE","PARÁ","6885.86534",267836,104820,104640,180,"3"
1505551,"PAU D'ARCO","NORTE","PARÁ","1671.4184641",6931,3222,3215,7,"3.1"
1505601,"PEIXE-BOI","NORTE","PARÁ","450.2239866",8285,3950,3948,2,"2.8"
1505635,"PIÇARRA","NORTE","PARÁ","3312.7085787",12832,5452,5438,14,"3.1"
1505650,"PLACAS","NORTE","PARÁ","7173.1995052",18668,8166,8158,8,"3.2"
1505700,"PONTA DE PEDRAS","NORTE","PARÁ","3363.7432251",24984,9505,9487,18,"3.5"
1505809,"PORTEL","NORTE","PARÁ","25386.1581012",62503,15318,15210,108,"4.7"
1505908,"PORTO DE MOZ","NORTE","PARÁ","17422.3293377",40597,10520,10513,7,"4.5"
1506005,"PRAINHA","NORTE","PARÁ","14788.1890222",35577,12611,12578,33,"3.8"
1506104,"PRIMAVERA","NORTE","PARÁ","259.3305174",10851,4346,4335,11,"3.1"
1506112,"QUATIPURU","NORTE","PARÁ","302.5856323",11524,4439,4436,3,"3.2"
1506138,"REDENÇÃO","NORTE","PARÁ","3823.8089223",85597,34459,34345,114,"3"
1506161,"RIO MARIA","NORTE","PARÁ","4114.6272666",18384,8205,8182,23,"2.8"
1506187,"RONDON DO PARÁ","NORTE","PARÁ","8246.394407",53143,16425,16397,28,"3.5"
1506195,"RURÓPOLIS","NORTE","PARÁ","7021.3205443",35769,11791,11700,91,"3.9"
1506203,"SALINÓPOLIS","NORTE","PARÁ","226.1201372",44772,25145,24985,160,"3.3"
1506302,"SALVATERRA","NORTE","PARÁ","918.5628414",24129,10152,10110,42,"3.3"
1506351,"SANTA BÁRBARA DO PARÁ","NORTE","PARÁ","278.153908",21087,9475,9472,3,"3.1"
1506401,"SANTA CRUZ DO ARARI","NORTE","PARÁ","1076.6516036",7445,2059,2049,10,"4.2"
1506500,"SANTA IZABEL DO PARÁ","NORTE","PARÁ","717.6623901",73019,26281,26258,23,"3.1"
1506559,"SANTA LUZIA DO PARÁ","NORTE","PARÁ","1346.5024048",20370,7917,7908,9,"3.2"
1506583,"SANTA MARIA DAS BARREIRAS","NORTE","PARÁ","10330.2142718",16548,7988,7916,72,"3"
1506609,"SANTA MARIA DO PARÁ","NORTE","PARÁ","457.7244341",24624,10335,10330,5,"2.9"
1506708,"SANTANA DO ARAGUAIA","NORTE","PARÁ","11591.4408634",32413,13964,13830,134,"3.1"
1506807,"SANTARÉM","NORTE","PARÁ","17899.2377107",331942,118573,118426,147,"3.5"
1506906,"SANTARÉM NOVO","NORTE","PARÁ","229.5095978",6116,2552,2548,4,"3.1"
1507003,"SANTO ANTÔNIO DO TAUÁ","NORTE","PARÁ","537.6178311",27461,12648,12642,6,"3.1"
1507102,"SÃO CAETANO DE ODIVELAS","NORTE","PARÁ","464.1657137",16666,6582,6576,6,"3.2"
1507151,"SÃO DOMINGOS DO ARAGUAIA","NORTE","PARÁ","1392.4642814",21092,8531,8528,3,"3.1"
1507201,"SÃO DOMINGOS DO CAPIM","NORTE","PARÁ","1686.7646625",30599,10085,10084,1,"3.6"
1507300,"SÃO FÉLIX DO XINGU","NORTE","PARÁ","84212.9009975",65418,26484,26357,127,"3.1"
1507409,"SÃO FRANCISCO DO PARÁ","NORTE","PARÁ","479.4411938",14894,6935,6927,8,"3"
1507458,"SÃO GERALDO DO ARAGUAIA","NORTE","PARÁ","3168.3860357",24255,9887,9869,18,"3.1"
1507466,"SÃO JOÃO DA PONTA","NORTE","PARÁ","195.9176367",4430,2521,2521,0,"3"
1507474,"SÃO JOÃO DE PIRABAS","NORTE","PARÁ","668.05776",20689,8748,8743,5,"3.2"
1507508,"SÃO JOÃO DO ARAGUAIA","NORTE","PARÁ","1279.8886348",13664,6042,6039,3,"3.1"
1507607,"SÃO MIGUEL DO GUAMÁ","NORTE","PARÁ","1094.5646323",52894,19551,19537,14,"3.2"
1507706,"SÃO SEBASTIÃO DA BOA VISTA","NORTE","PARÁ","1632.251288",25643,7825,7800,25,"3.9"
1507755,"SAPUCAIA","NORTE","PARÁ","1298.1899921",5847,2117,2087,30,"3.3"
1507805,"SENADOR JOSÉ PORFÍRIO","NORTE","PARÁ","14419.9172051",22576,8991,8969,22,"3.4"
1507904,"SOURE","NORTE","PARÁ","2857.3493746",24204,9360,9336,24,"3.4"
1507953,"TAILÂNDIA","NORTE","PARÁ","4430.477265",72493,24962,24922,40,"3.4"
1507961,"TERRA ALTA","NORTE","PARÁ","204.9703829",10400,4759,4756,3,"3.1"
1507979,"TERRA SANTA","NORTE","PARÁ","1895.8835205",18782,6421,6405,16,"3.8"
1508001,"TOMÉ-AÇU","NORTE","PARÁ","5145.3608075",67585,24276,24205,71,"3.4"
1508035,"TRACUATEUA","NORTE","PARÁ","868.0245755",28595,10705,10703,2,"3.3"
1508050,"TRAIRÃO","NORTE","PARÁ","11991.0849572",15242,5936,5929,7,"3.2"
1508084,"TUCUMÃ","NORTE","PARÁ","2512.5935615",39550,14743,14711,32,"3.1"
1508100,"TUCURUÍ","NORTE","PARÁ","2084.2867788",91306,34412,34367,45,"3.3"
1508126,"ULIANÓPOLIS","NORTE","PARÁ","5088.4682858",37972,10653,10626,27,"3.9"
1508159,"URUARÁ","NORTE","PARÁ","10791.4000318",43558,19612,19602,10,"3"
1508209,"VIGIA","NORTE","PARÁ","401.5885929",50832,19269,19254,15,"3.2"
1508308,"VISEU","NORTE","PARÁ","4972.9356614",58692,19279,19260,19,"3.6"
1508357,"VITÓRIA DO XINGU","NORTE","PARÁ","3089.5366742",15607,7282,7273,9,"3.2"
1508407,"XINGUARA","NORTE","PARÁ","3779.3481203",52893,20962,20892,70,"2.9"
1600055,"SERRA DO NAVIO","NORTE","AMAPÁ","7713.0461401",4673,1850,1841,9,"3.4"
1600105,"AMAPÁ","NORTE","AMAPÁ","8454.8462984",7943,2579,2554,25,"3.8"
1600154,"PEDRA BRANCA DO AMAPARI","NORTE","AMAPÁ","9622.2902635",12847,4777,4745,32,"3.9"
1600204,"CALÇOENE","NORTE","AMAPÁ","14117.2974533",10612,3965,3912,53,"3.8"
1600212,"CUTIAS","NORTE","AMAPÁ","2179.1142345",4461,1514,1505,9,"3.8"
1600238,"FERREIRA GOMES","NORTE","AMAPÁ","4973.8551406",6666,2764,2743,21,"3.7"
1600253,"ITAUBAL","NORTE","AMAPÁ","1622.8665281",5599,2032,2023,9,"4.1"
1600279,"LARANJAL DO JARI","NORTE","AMAPÁ","30782.9982855",35114,13655,13643,12,"3.4"
1600303,"MACAPÁ","NORTE","AMAPÁ","6563.848689",442933,149531,149377,154,"3.6"
1600402,"MAZAGÃO","NORTE","AMAPÁ","13294.777824",21924,7572,7544,28,"4.1"
1600501,"OIAPOQUE","NORTE","AMAPÁ","23034.3916536",27482,9646,9586,60,"3.8"
1600535,"PORTO GRANDE","NORTE","AMAPÁ","4428.0133743",17848,7881,7865,16,"3.6"
1600550,"PRACUÚBA","NORTE","AMAPÁ","4948.5082859",3803,1324,1324,0,"4.2"
1600600,"SANTANA","NORTE","AMAPÁ","1541.2247495",107618,34703,34670,33,"3.7"
1600709,"TARTARUGALZINHO","NORTE","AMAPÁ","6684.7049501",12945,4235,4226,9,"3.9"
1600808,"VITÓRIA DO JARI","NORTE","AMAPÁ","2508.9785959",11291,4054,4008,46,"3.7"
1700251,"ABREULÂNDIA","NORTE","TOCANTINS","1906.2952007",2576,1302,1287,15,"2.8"
1700301,"AGUIARNÓPOLIS","NORTE","TOCANTINS","236.7920051",4497,1825,1823,2,"3.1"
1700350,"ALIANÇA DO TOCANTINS","NORTE","TOCANTINS","1580.9992542",5147,2549,2547,2,"2.8"
1700400,"ALMAS","NORTE","TOCANTINS","4007.1521813",6499,2993,2982,11,"3.1"
1700707,"ALVORADA","NORTE","TOCANTINS","1207.2007308",8802,3709,3699,10,"2.8"
1701002,"ANANÁS","NORTE","TOCANTINS","1581.058174",10325,4030,4004,26,"3.2"
1701051,"ANGICO","NORTE","TOCANTINS","447.5485544",2876,1163,1163,0,"3.2"
1701101,"APARECIDA DO RIO NEGRO","NORTE","TOCANTINS","1159.033906",4856,2283,2268,15,"2.9"
1701309,"ARAGOMINAS","NORTE","TOCANTINS","1168.2132099",5290,2253,2249,4,"2.9"
1701903,"ARAGUACEMA","NORTE","TOCANTINS","2774.5048452",5927,2983,2961,22,"2.9"
1702000,"ARAGUAÇU","NORTE","TOCANTINS","5155.2230128",8133,4313,4305,8,"2.6"
1702109,"ARAGUAÍNA","NORTE","TOCANTINS","4004.6454865",171301,72039,71980,59,"3"
1702158,"ARAGUANÃ","NORTE","TOCANTINS","834.8338955",4310,1940,1928,12,"2.9"
1702208,"ARAGUATINS","NORTE","TOCANTINS","2633.2776963",31918,13313,13276,37,"3.1"
1702307,"ARAPOEMA","NORTE","TOCANTINS","1558.1379425",5550,2419,2413,6,"2.8"
1702406,"ARRAIAS","NORTE","TOCANTINS","5803.0853357",10287,5513,5500,13,"2.7"
1702554,"AUGUSTINÓPOLIS","NORTE","TOCANTINS","388.809675",17484,6806,6796,10,"3.1"
1702703,"AURORA DO TOCANTINS","NORTE","TOCANTINS","696.1938092",3342,1804,1795,9,"2.6"
1702901,"AXIXÁ DO TOCANTINS","NORTE","TOCANTINS","153.5391319",10262,3376,3376,0,"3.5"
1703008,"BABAÇULÂNDIA","NORTE","TOCANTINS","1790.2973834",7880,3810,3810,0,"2.9"
1703057,"BANDEIRANTES DO TOCANTINS","NORTE","TOCANTINS","1540.5409578",3407,1462,1460,2,"2.9"
1703073,"BARRA DO OURO","NORTE","TOCANTINS","1105.8398094",4476,1939,1937,2,"3.3"
1703107,"BARROLÂNDIA","NORTE","TOCANTINS","697.7585944",4846,2227,2222,5,"2.7"
1703206,"BERNARDO SAYÃO","NORTE","TOCANTINS","924.0448123",4229,2091,2089,2,"2.8"
1703305,"BOM JESUS DO TOCANTINS","NORTE","TOCANTINS","1326.9472661",4038,1725,1723,2,"3"
1703602,"BRASILÂNDIA DO TOCANTINS","NORTE","TOCANTINS","645.9083078",1974,879,879,0,"2.9"
1703701,"BREJINHO DE NAZARÉ","NORTE","TOCANTINS","1722.590121",4725,2347,2347,0,"2.8"
1703800,"BURITI DO TOCANTINS","NORTE","TOCANTINS","252.7301544",10307,3004,3004,0,"3.6"
1703826,"CACHOEIRINHA","NORTE","TOCANTINS","351.5352688",1961,790,789,1,"3.1"
1703842,"CAMPOS LINDOS","NORTE","TOCANTINS","3234.4447306",8653,3033,3021,12,"3.6"
1703867,"CARIRI DO TOCANTINS","NORTE","TOCANTINS","1126.2911136",4007,1642,1639,3,"2.8"
1703883,"CARMOLÂNDIA","NORTE","TOCANTINS","339.3655423",2201,900,900,0,"2.9"
1703891,"CARRASCO BONITO","NORTE","TOCANTINS","190.3523386",3318,1345,1345,0,"3.3"
1703909,"CASEARA","NORTE","TOCANTINS","1680.0142051",4847,2115,2090,25,"3"
1704105,"CENTENÁRIO","NORTE","TOCANTINS","1953.134061",2131,1071,1071,0,"2.8"
1704600,"CHAPADA DE AREIA","NORTE","TOCANTINS","658.5636634",1501,916,916,0,"2.7"
1705102,"CHAPADA DA NATIVIDADE","NORTE","TOCANTINS","1640.832615",3117,1369,1363,6,"3"
1705508,"COLINAS DO TOCANTINS","NORTE","TOCANTINS","842.4878647",34233,13464,13448,16,"2.9"
1705557,"COMBINADO","NORTE","TOCANTINS","208.7907746",4756,2180,2175,5,"2.7"
1705607,"CONCEIÇÃO DO TOCANTINS","NORTE","TOCANTINS","2530.6470231",3887,1833,1830,3,"3"
1706001,"COUTO MAGALHÃES","NORTE","TOCANTINS","1584.1962133",5331,2549,2540,9,"2.9"
1706100,"CRISTALÂNDIA","NORTE","TOCANTINS","1850.7501476",6371,2987,2977,10,"2.7"
1706258,"CRIXÁS DO TOCANTINS","NORTE","TOCANTINS","983.765713",1470,680,679,1,"2.9"
1706506,"DARCINÓPOLIS","NORTE","TOCANTINS","1641.7697123",5827,2595,2590,5,"2.9"
1707009,"DIANÓPOLIS","NORTE","TOCANTINS","3318.0935977",17739,7405,7387,18,"3"
1707108,"DIVINÓPOLIS DO TOCANTINS","NORTE","TOCANTINS","2358.2820089",7024,3407,3391,16,"2.8"
1707207,"DOIS IRMÃOS DO TOCANTINS","NORTE","TOCANTINS","3747.6447961",6327,3126,3122,4,"2.8"
1707306,"DUERÉ","NORTE","TOCANTINS","3420.6571717",4248,2349,2349,0,"2.6"
1707405,"ESPERANTINA","NORTE","TOCANTINS","506.1749455",7530,3213,3212,1,"3.2"
1707553,"FÁTIMA","NORTE","TOCANTINS","380.37344",3467,1499,1495,4,"2.9"
1707652,"FIGUEIRÓPOLIS","NORTE","TOCANTINS","1935.7085861",5211,2494,2489,5,"2.7"
1707702,"FILADÉLFIA","NORTE","TOCANTINS","1991.257985",7712,3186,3184,2,"3"
1708205,"FORMOSO DO ARAGUAIA","NORTE","TOCANTINS","13431.8606284",18881,8415,8358,57,"2.9"
1708254,"TABOCÃO","NORTE","TOCANTINS","624.4628722",3455,1485,1484,1,"3"
1708304,"GOIANORTE","NORTE","TOCANTINS","1797.2289958",4738,2274,2268,6,"2.8"
1709005,"GOIATINS","NORTE","TOCANTINS","6414.846485",12433,4787,4781,6,"3.4"
1709302,"GUARAÍ","NORTE","TOCANTINS","2106.7525504",24775,10321,10302,19,"2.8"
1709500,"GURUPI","NORTE","TOCANTINS","1844.1640585",85125,36801,36784,17,"2.8"
1709807,"IPUEIRAS","NORTE","TOCANTINS","821.1519689",1590,867,864,3,"2.8"
1710508,"ITACAJÁ","NORTE","TOCANTINS","3047.203884",6819,2798,2794,4,"3.2"
1710706,"ITAGUATINS","NORTE","TOCANTINS","730.1628438",5172,2691,2687,4,"3"
1710904,"ITAPIRATINS","NORTE","TOCANTINS","1246.3486653",3577,1703,1702,1,"2.8"
1711100,"ITAPORÃ DO TOCANTINS","NORTE","TOCANTINS","969.79385",2404,1117,1113,4,"2.9"
1711506,"JAÚ DO TOCANTINS","NORTE","TOCANTINS","2167.2006413",3334,1866,1862,4,"2.7"
1711803,"JUARINA","NORTE","TOCANTINS","483.4519841",2243,1111,1093,18,"3"
1711902,"LAGOA DA CONFUSÃO","NORTE","TOCANTINS","10563.1814688",15288,5589,5576,13,"3.2"
1711951,"LAGOA DO TOCANTINS","NORTE","TOCANTINS","917.6319071",3516,1445,1445,0,"3.3"
1712009,"LAJEADO","NORTE","TOCANTINS","318.2918083",3357,1777,1773,4,"2.9"
1712157,"LAVANDEIRA","NORTE","TOCANTINS","468.005932",1626,874,873,1,"2.8"
1712405,"LIZARDA","NORTE","TOCANTINS","5716.6413433",2999,1478,1474,4,"3"
1712454,"LUZINÓPOLIS","NORTE","TOCANTINS","281.5427277",2717,1091,1087,4,"3.1"
1712504,"MARIANÓPOLIS DO TOCANTINS","NORTE","TOCANTINS","2089.5753431",4615,2094,2039,55,"2.8"
1712702,"MATEIROS","NORTE","TOCANTINS","9589.2733114",2748,1042,1031,11,"3.4"
1712801,"MAURILÂNDIA DO TOCANTINS","NORTE","TOCANTINS","736.3031921",3095,1301,1300,1,"3.1"
1713205,"MIRACEMA DO TOCANTINS","NORTE","TOCANTINS","2663.7447709",18566,8857,8836,21,"2.9"
1713304,"MIRANORTE","NORTE","TOCANTINS","1033.3005875",12701,5258,5251,7,"2.9"
1713601,"MONTE DO CARMO","NORTE","TOCANTINS","3601.2048854",5694,2747,2744,3,"2.9"
1713700,"MONTE SANTO DO TOCANTINS","NORTE","TOCANTINS","1072.9201213",2396,1266,1264,2,"2.7"
1713809,"PALMEIRAS DO TOCANTINS","NORTE","TOCANTINS","743.4074027",4872,2097,2094,3,"3.1"
1713957,"MURICILÂNDIA","NORTE","TOCANTINS","1194.3675253",3367,1287,1279,8,"2.8"
1714203,"NATIVIDADE","NORTE","TOCANTINS","3241.6720324",8754,3864,3856,8,"2.9"
1714302,"NAZARÉ","NORTE","TOCANTINS","395.9970517",4521,1935,1935,0,"3"
1714880,"NOVA OLINDA","NORTE","TOCANTINS","1567.8343304",10367,4644,4641,3,"2.9"
1715002,"NOVA ROSALÂNDIA","NORTE","TOCANTINS","514.7911187",3362,1469,1469,0,"2.9"
1715101,"NOVO ACORDO","NORTE","TOCANTINS","2678.2620066",3969,1772,1766,6,"3"
1715150,"NOVO ALEGRE","NORTE","TOCANTINS","200.4122381",1846,933,932,1,"2.6"
1715259,"NOVO JARDIM","NORTE","TOCANTINS","1213.8934455",2230,1008,1007,1,"3.1"
1715507,"OLIVEIRA DE FÁTIMA","NORTE","TOCANTINS","209.2921753",1164,555,555,0,"2.9"
1715705,"PALMEIRANTE","NORTE","TOCANTINS","2638.4648055",4798,2488,2483,5,"2.9"
1715754,"PALMEIRÓPOLIS","NORTE","TOCANTINS","1708.9806245",6975,3620,3617,3,"2.7"
1716109,"PARAÍSO DO TOCANTINS","NORTE","TOCANTINS","1292.2668978",52360,20983,20962,21,"2.8"
1716208,"PARANÃ","NORTE","TOCANTINS","11217.372875",10542,5736,5700,36,"2.9"
1716307,"PAU D'ARCO","NORTE","TOCANTINS","1375.5513205",4043,1898,1889,9,"2.9"
1716505,"PEDRO AFONSO","NORTE","TOCANTINS","2019.5564165",14055,5847,5831,16,"3"
1716604,"PEIXE","NORTE","TOCANTINS","5303.6119856",9317,5346,5320,26,"2.7"
1716653,"PEQUIZEIRO","NORTE","TOCANTINS","1206.1179777",4921,2202,2199,3,"2.9"
1716703,"COLMÉIA","NORTE","TOCANTINS","1161.0297724",8941,4065,4054,11,"2.8"
1717008,"PINDORAMA DO TOCANTINS","NORTE","TOCANTINS","1560.5507132",4478,2113,2111,2,"3"
1717206,"PIRAQUÊ","NORTE","TOCANTINS","1363.4115315",2282,1178,1176,2,"2.9"
1717503,"PIUM","NORTE","TOCANTINS","10003.5491933",7128,3323,3290,33,"3"
1717800,"PONTE ALTA DO BOM JESUS","NORTE","TOCANTINS","1718.7906989",4220,2259,2255,4,"2.7"
1717909,"PONTE ALTA DO TOCANTINS","NORTE","TOCANTINS","6542.838051",7586,3312,3309,3,"3"
1718006,"PORTO ALEGRE DO TOCANTINS","NORTE","TOCANTINS","506.7165145",2866,1227,1226,1,"3.1"
1718204,"PORTO NACIONAL","NORTE","TOCANTINS","4434.6797563",64418,29950,29924,26,"3"
1718303,"PRAIA NORTE","NORTE","TOCANTINS","300.99901",9044,2884,2882,2,"3.7"
1718402,"PRESIDENTE KENNEDY","NORTE","TOCANTINS","771.7163236",3047,1323,1321,2,"2.9"
1718451,"PUGMIL","NORTE","TOCANTINS","401.1736781",2193,1000,998,2,"2.8"
1718501,"RECURSOLÂNDIA","NORTE","TOCANTINS","2215.6690543",3421,1327,1327,0,"3.3"
1718550,"RIACHINHO","NORTE","TOCANTINS","512.1562199",3960,1672,1669,3,"3.1"
1718659,"RIO DA CONCEIÇÃO","NORTE","TOCANTINS","845.8232618",1768,857,855,2,"3.1"
1718709,"RIO DOS BOIS","NORTE","TOCANTINS","847.2548225",2738,1307,1306,1,"2.8"
1718758,"RIO SONO","NORTE","TOCANTINS","6346.2794619",4841,2532,2532,0,"2.9"
1718808,"SAMPAIO","NORTE","TOCANTINS","222.4354647",4215,1561,1559,2,"3.4"
1718840,"SANDOLÂNDIA","NORTE","TOCANTINS","3535.1351315",3723,1880,1874,6,"2.8"
1718865,"SANTA FÉ DO ARAGUAIA","NORTE","TOCANTINS","1671.238548",7216,2682,2668,14,"3"
1718881,"SANTA MARIA DO TOCANTINS","NORTE","TOCANTINS","1412.3180428",2680,1291,1290,1,"2.9"
1718899,"SANTA RITA DO TOCANTINS","NORTE","TOCANTINS","3281.2189346",2219,1129,1126,3,"2.8"
1718907,"SANTA ROSA DO TOCANTINS","NORTE","TOCANTINS","1804.6864918",4653,2262,2262,0,"3"
1719004,"SANTA TEREZA DO TOCANTINS","NORTE","TOCANTINS","539.511182",2781,1196,1191,5,"3.3"
1720002,"SANTA TEREZINHA DO TOCANTINS","NORTE","TOCANTINS","274.1036027",2406,1039,1039,0,"3"
1720101,"SÃO BENTO DO TOCANTINS","NORTE","TOCANTINS","1099.5801466",5654,2210,2204,6,"3.3"
1720150,"SÃO FÉLIX DO TOCANTINS","NORTE","TOCANTINS","1913.1101795",1783,664,661,3,"3.2"
1720200,"SÃO MIGUEL DO TOCANTINS","NORTE","TOCANTINS","406.9573995",13241,5594,5594,0,"3.3"
1720259,"SÃO SALVADOR DO TOCANTINS","NORTE","TOCANTINS","1424.7525883",2385,1500,1497,3,"2.8"
1720309,"SÃO SEBASTIÃO DO TOCANTINS","NORTE","TOCANTINS","289.5968459",4100,1653,1650,3,"3.3"
1720499,"SÃO VALÉRIO","NORTE","TOCANTINS","2520.4650578",4422,2297,2294,3,"2.6"
1720655,"SILVANÓPOLIS","NORTE","TOCANTINS","1258.7706656",5108,2344,2344,0,"3"
1720804,"SÍTIO NOVO DO TOCANTINS","NORTE","TOCANTINS","307.0946347",10830,3777,3774,3,"3.3"
1720853,"SUCUPIRA","NORTE","TOCANTINS","1018.2221064",1577,848,848,0,"2.7"
1720903,"TAGUATINGA","NORTE","TOCANTINS","2341.9190645",14011,6680,6674,6,"2.8"
1720937,"TAIPAS DO TOCANTINS","NORTE","TOCANTINS","1105.3025278",2021,860,852,8,"3"
1720978,"TALISMÃ","NORTE","TOCANTINS","2155.5030226",2456,1376,1368,8,"2.7"
1721000,"PALMAS","NORTE","TOCANTINS","2227.3285212",302692,129424,129313,111,"2.8"
1721109,"TOCANTÍNIA","NORTE","TOCANTINS","2609.7751304",7459,2774,2768,6,"3.7"
1721208,"TOCANTINÓPOLIS","NORTE","TOCANTINS","1083.5995478",22615,8619,8593,26,"3"
1721257,"TUPIRAMA","NORTE","TOCANTINS","706.8831235",1909,828,828,0,"2.9"
1721307,"TUPIRATINS","NORTE","TOCANTINS","889.1257384",1874,971,968,3,"2.8"
1722081,"WANDERLÂNDIA","NORTE","TOCANTINS","1365.431261",10522,4574,4569,5,"3"
1722107,"XAMBIOÁ","NORTE","TOCANTINS","1190.4894813",10517,4635,4627,8,"3"
2100055,"AÇAILÂNDIA","NORDESTE","MARANHÃO","5805.1593653",106550,44370,44339,31,"3.1"
2100105,"AFONSO CUNHA","NORDESTE","MARANHÃO","371.3382337",6144,2106,2104,2,"3.6"
2100154,"ÁGUA DOCE DO MARANHÃO","NORDESTE","MARANHÃO","442.2917386",12142,4311,4308,3,"3.4"
2100204,"ALCÂNTARA","NORDESTE","MARANHÃO","1167.9638156",18467,8552,8541,11,"2.9"
2100303,"ALDEIAS ALTAS","NORDESTE","MARANHÃO","1942.1213079",23286,8008,8003,5,"3.5"
2100402,"ALTAMIRA DO MARANHÃO","NORDESTE","MARANHÃO","524.3738281",6447,2373,2372,1,"3.3"
2100436,"ALTO ALEGRE DO MARANHÃO","NORDESTE","MARANHÃO","392.7498341",24048,9181,9177,4,"3.2"
2100477,"ALTO ALEGRE DO PINDARÉ","NORDESTE","MARANHÃO","1875.9011514",25710,9930,9921,9,"3.5"
2100501,"ALTO PARNAÍBA","NORDESTE","MARANHÃO","11127.3839526",11109,4381,4363,18,"3.2"
2100550,"AMAPÁ DO MARANHÃO","NORDESTE","MARANHÃO","502.4025665",7170,2560,2559,1,"3.5"
2100600,"AMARANTE DO MARANHÃO","NORDESTE","MARANHÃO","7439.6150825",37085,14830,14809,21,"3.4"
2100709,"ANAJATUBA","NORDESTE","MARANHÃO","940.489344",25322,9576,9570,6,"3.1"
2100808,"ANAPURUS","NORDESTE","MARANHÃO","608.9034139",13793,4935,4930,5,"3.4"
2100832,"APICUM-AÇU","NORDESTE","MARANHÃO","341.1202842",17519,5776,5768,8,"3.5"
2100873,"ARAGUANÃ","NORDESTE","MARANHÃO","805.1940786",11181,3902,3900,2,"3.5"
2100907,"ARAIOSES","NORDESTE","MARANHÃO","1789.7297533",39052,14738,14732,6,"3.3"
2100956,"ARAME","NORDESTE","MARANHÃO","2976.0386531",25517,9532,9520,12,"3.6"
2101004,"ARARI","NORDESTE","MARANHÃO","1100.2748551",29472,10563,10555,8,"3.3"
2101103,"AXIXÁ","NORDESTE","MARANHÃO","160.4620207",11790,4167,4164,3,"3.5"
2101202,"BACABAL","NORDESTE","MARANHÃO","1656.7361228",103711,38964,38937,27,"3.1"
2101251,"BACABEIRA","NORDESTE","MARANHÃO","542.9614503",16966,6960,6951,9,"3.2"
2101301,"BACURI","NORDESTE","MARANHÃO","850.4910149",16290,6185,6180,5,"3.2"
2101350,"BACURITUBA","NORDESTE","MARANHÃO","413.6510446",5252,2204,2201,3,"3"
2101400,"BALSAS","NORDESTE","MARANHÃO","13141.162496",101767,36996,36958,38,"3.3"
2101509,"BARÃO DE GRAJAÚ","NORDESTE","MARANHÃO","2209.4140495",18984,8590,8586,4,"3"
2101608,"BARRA DO CORDA","NORDESTE","MARANHÃO","5187.6731775",84532,36839,36812,27,"3.1"
2101707,"BARREIRINHAS","NORDESTE","MARANHÃO","3046.3080183",65589,25510,25361,149,"3.6"
2101731,"BELÁGUA","NORDESTE","MARANHÃO","569.6055385",8460,2536,2536,0,"4.1"
2101772,"BELA VISTA DO MARANHÃO","NORDESTE","MARANHÃO","147.9544924",11750,4182,4181,1,"3.4"
2101806,"BENEDITO LEITE","NORDESTE","MARANHÃO","1784.640006",5469,2374,2373,1,"3.1"
2101905,"BEQUIMÃO","NORDESTE","MARANHÃO","790.2219139",19584,8148,8138,10,"2.9"
2101939,"BERNARDO DO MEARIM","NORDESTE","MARANHÃO","247.1856965",5840,2152,2152,0,"3.2"
2101970,"BOA VISTA DO GURUPI","NORDESTE","MARANHÃO","400.3498723",7574,2827,2823,4,"3.5"
2102002,"BOM JARDIM","NORDESTE","MARANHÃO","6588.3798828",33100,12918,12909,9,"3.4"
2102036,"BOM JESUS DAS SELVAS","NORDESTE","MARANHÃO","2676.9796843",28599,11565,11547,18,"3.5"
2102077,"BOM LUGAR","NORDESTE","MARANHÃO","445.1706412",12212,4138,4138,0,"3.4"
2102101,"BREJO","NORDESTE","MARANHÃO","1073.25822",34120,11503,11465,38,"3.5"
2102150,"BREJO DE AREIA","NORDESTE","MARANHÃO","986.0357927",9218,3454,3454,0,"3.6"
2102200,"BURITI","NORDESTE","MARANHÃO","1475.7787316",29685,9907,9897,10,"3.7"
2102309,"BURITI BRAVO","NORDESTE","MARANHÃO","1582.5518168",22455,8641,8611,30,"3.4"
2102325,"BURITICUPU","NORDESTE","MARANHÃO","2544.8573041",55499,21077,21034,43,"3.4"
2102358,"BURITIRANA","NORDESTE","MARANHÃO","820.9681154",12918,5553,5550,3,"3.1"
2102374,"CACHOEIRA GRANDE","NORDESTE","MARANHÃO","707.2363028",9732,3316,3314,2,"3.6"
2102408,"CAJAPIÓ","NORDESTE","MARANHÃO","545.2440021",10121,3658,3658,0,"3.2"
2102507,"CAJARI","NORDESTE","MARANHÃO","662.0659735",16412,5786,5786,0,"3.3"
2102556,"CAMPESTRE DO MARANHÃO","NORDESTE","MARANHÃO","613.5289729",12301,4951,4948,3,"3.2"
2102606,"CÂNDIDO MENDES","NORDESTE","MARANHÃO","1634.8617706",19932,7019,7018,1,"3.5"
2102705,"CANTANHEDE","NORDESTE","MARANHÃO","773.0094079",24303,6554,6547,7,"4"
2102754,"CAPINZAL DO NORTE","NORDESTE","MARANHÃO","590.2707136",11374,4439,4438,1,"3.2"
2102804,"CAROLINA","NORDESTE","MARANHÃO","6267.6746461",24062,9989,9913,76,"3.1"
2102903,"CARUTAPERA","NORDESTE","MARANHÃO","1260.9767035",24238,8268,8264,4,"3.4"
2103000,"CAXIAS","NORDESTE","MARANHÃO","5201.9266165",156973,60143,60112,31,"3.3"
2103109,"CEDRAL","NORDESTE","MARANHÃO","285.2108087",10208,3759,3757,2,"3.2"
2103125,"CENTRAL DO MARANHÃO","NORDESTE","MARANHÃO","319.5378892",7094,2800,2798,2,"3.2"
2103158,"CENTRO DO GUILHERME","NORDESTE","MARANHÃO","1167.8482712",12342,3943,3941,2,"3.8"
2103174,"CENTRO NOVO DO MARANHÃO","NORDESTE","MARANHÃO","8401.0023553",16267,5904,5895,9,"3.6"
2103208,"CHAPADINHA","NORDESTE","MARANHÃO","3247.3849502",81386,31620,31595,25,"3.4"
2103257,"CIDELÂNDIA","NORDESTE","MARANHÃO","1462.8090396",12878,5523,5512,11,"3.1"
2103307,"CODÓ","NORDESTE","MARANHÃO","4361.6061912",114275,42380,42318,62,"3.3"
2103406,"COELHO NETO","NORDESTE","MARANHÃO","977.078872",41658,14255,14242,13,"3.5"
2103505,"COLINAS","NORDESTE","MARANHÃO","1978.6949689",40316,16331,16311,20,"3.2"
2103554,"CONCEIÇÃO DO LAGO-AÇU","NORDESTE","MARANHÃO","725.6642674",14915,4828,4826,2,"3.6"
2103604,"COROATÁ","NORDESTE","MARANHÃO","2263.6913647",59566,23416,23386,30,"3.1"
2103703,"CURURUPU","NORDESTE","MARANHÃO","1257.6067523",31558,12450,12442,8,"3.1"
2103752,"DAVINÓPOLIS","NORDESTE","MARANHÃO","332.2487296",14404,5924,5922,2,"3.1"
2103802,"DOM PEDRO","NORDESTE","MARANHÃO","358.4932368",23053,9015,9006,9,"3.2"
2103901,"DUQUE BACELAR","NORDESTE","MARANHÃO","317.4935704",10223,3217,3216,1,"3.7"
2104008,"ESPERANTINÓPOLIS","NORDESTE","MARANHÃO","452.4110796",18311,6968,6962,6,"3.3"
2104057,"ESTREITO","NORDESTE","MARANHÃO","2720.2661025",33294,14127,14112,15,"3.1"
2104073,"FEIRA NOVA DO MARANHÃO","NORDESTE","MARANHÃO","1625.8219637",8048,2980,2980,0,"3.2"
2104081,"FERNANDO FALCÃO","NORDESTE","MARANHÃO","5086.5905033",10873,3313,3309,4,"4.1"
2104099,"FORMOSA DA SERRA NEGRA","NORDESTE","MARANHÃO","3690.610018",17719,6645,6634,11,"3.4"
2104107,"FORTALEZA DOS NOGUEIRAS","NORDESTE","MARANHÃO","1853.4064984",12640,4870,4864,6,"3.2"
2104206,"FORTUNA","NORDESTE","MARANHÃO","834.8301945",16976,6505,6503,2,"3.3"
2104305,"GODOFREDO VIANA","NORDESTE","MARANHÃO","720.1283958",10186,3867,3839,28,"3.2"
2104404,"GONÇALVES DIAS","NORDESTE","MARANHÃO","883.5877671",17206,6796,6792,4,"3.2"
2104503,"GOVERNADOR ARCHER","NORDESTE","MARANHÃO","445.8563907",10231,3569,3568,1,"3.4"
2104552,"GOVERNADOR EDISON LOBÃO","NORDESTE","MARANHÃO","615.9573543",18411,8633,8618,15,"3.1"
2104602,"GOVERNADOR EUGÊNIO BARROS","NORDESTE","MARANHÃO","647.988863",13930,5190,5188,2,"3.2"
2104628,"GOVERNADOR LUIZ ROCHA","NORDESTE","MARANHÃO","401.5868018",7063,2885,2885,0,"3.2"
2104651,"GOVERNADOR NEWTON BELLO","NORDESTE","MARANHÃO","1144.1460342",10713,3423,3417,6,"3.8"
2104677,"GOVERNADOR NUNES FREIRE","NORDESTE","MARANHÃO","1037.1354227",23128,8559,8550,9,"3.4"
2104701,"GRAÇA ARANHA","NORDESTE","MARANHÃO","271.4447082",6023,2533,2532,1,"3"
2104800,"GRAJAÚ","NORDESTE","MARANHÃO","8861.7175679",73872,28279,28226,53,"3.4"
2104909,"GUIMARÃES","NORDESTE","MARANHÃO","478.8571783",10290,4577,4570,7,"2.9"
2105005,"HUMBERTO DE CAMPOS","NORDESTE","MARANHÃO","1714.6254596",25680,9833,9823,10,"3.7"
2105104,"ICATU","NORDESTE","MARANHÃO","1124.4455393",24794,8411,8406,5,"3.6"
2105153,"IGARAPÉ DO MEIO","NORDESTE","MARANHÃO","368.6847198",13974,4656,4652,4,"3.5"
2105203,"IGARAPÉ GRANDE","NORDESTE","MARANHÃO","346.2176207",10231,3862,3859,3,"3.2"
2105302,"IMPERATRIZ","NORDESTE","MARANHÃO","1369.0392495",273110,110137,110044,93,"3"
2105351,"ITAIPAVA DO GRAJAÚ","NORDESTE","MARANHÃO","1244.3976865",13828,4919,4919,0,"3.6"
2105401,"ITAPECURU MIRIM","NORDESTE","MARANHÃO","1480.6414629",60440,24831,24790,41,"3.2"
2105427,"ITINGA DO MARANHÃO","NORDESTE","MARANHÃO","3583.4234442",22513,9356,9331,25,"3.1"
2105450,"JATOBÁ","NORDESTE","MARANHÃO","591.6162707",7471,2899,2899,0,"3.3"
2105476,"JENIPAPO DOS VIEIRAS","NORDESTE","MARANHÃO","1962.3620281",17076,5613,5612,1,"3.6"
2105500,"JOÃO LISBOA","NORDESTE","MARANHÃO","1137.1041073",24709,10003,9974,29,"3.2"
2105609,"JOSELÂNDIA","NORDESTE","MARANHÃO","703.0814174",14924,6056,6055,1,"3.3"
2105658,"JUNCO DO MARANHÃO","NORDESTE","MARANHÃO","568.49907",5146,2060,2059,1,"3.4"
2105708,"LAGO DA PEDRA","NORDESTE","MARANHÃO","1240.4443551",44403,16420,16401,19,"3.3"
2105807,"LAGO DO JUNCO","NORDESTE","MARANHÃO","328.5251103",9506,3539,3538,1,"3.3"
2105906,"LAGO VERDE","NORDESTE","MARANHÃO","631.4553446",14769,5346,5345,1,"3.4"
2105922,"LAGOA DO MATO","NORDESTE","MARANHÃO","1512.984987",10572,3916,3916,0,"3.3"
2105948,"LAGO DOS RODRIGUES","NORDESTE","MARANHÃO","220.775591",8758,3391,3388,3,"3.1"
2105963,"LAGOA GRANDE DO MARANHÃO","NORDESTE","MARANHÃO","744.1993779",11411,4567,4566,1,"3.4"
2105989,"LAJEADO NOVO","NORDESTE","MARANHÃO","1063.6195231",7057,2954,2954,0,"3"
2106003,"LIMA CAMPOS","NORDESTE","MARANHÃO","321.931713",11297,4587,4587,0,"3.1"
2106102,"LORETO","NORDESTE","MARANHÃO","3597.2307342",11597,4287,4286,1,"3.6"
2106201,"LUÍS DOMINGUES","NORDESTE","MARANHÃO","472.2955911",7161,2406,2404,2,"3.4"
2106300,"MAGALHÃES DE ALMEIDA","NORDESTE","MARANHÃO","434.4328291",13807,5068,5064,4,"3.3"
2106326,"MARACAÇUMÉ","NORDESTE","MARANHÃO","635.7576014",21149,7333,7321,12,"3.5"
2106359,"MARAJÁ DO SENA","NORDESTE","MARANHÃO","1402.5931634",7027,2985,2984,1,"3.7"
2106375,"MARANHÃOZINHO","NORDESTE","MARANHÃO","760.9418079",13761,3953,3951,2,"4.1"
2106409,"MATA ROMA","NORDESTE","MARANHÃO","548.5474222",17090,6227,6223,4,"3.6"
2106508,"MATINHA","NORDESTE","MARANHÃO","410.6331619",22034,8320,8312,8,"3.2"
2106607,"MATÕES","NORDESTE","MARANHÃO","2108.670976",32174,12244,12237,7,"3.4"
2106631,"MATÕES DO NORTE","NORDESTE","MARANHÃO","794.453533",17432,4190,4185,5,"4.5"
2106672,"MILAGRES DO MARANHÃO","NORDESTE","MARANHÃO","634.8179066",8818,2951,2950,1,"3.7"
2106706,"MIRADOR","NORDESTE","MARANHÃO","8522.3507894",21030,8406,8404,2,"3.4"
2106755,"MIRANDA DO NORTE","NORDESTE","MARANHÃO","341.1069407",23864,6867,6842,25,"3.6"
2106805,"MIRINZAL","NORDESTE","MARANHÃO","686.943928",13978,5653,5647,6,"3.1"
2106904,"MONÇÃO","NORDESTE","MARANHÃO","1245.5478953",27751,9589,9587,2,"3.5"
2107001,"MONTES ALTOS","NORDESTE","MARANHÃO","1488.513282",9106,3643,3638,5,"3.2"
2107100,"MORROS","NORDESTE","MARANHÃO","1712.1214585",18554,6965,6943,22,"3.6"
2107209,"NINA RODRIGUES","NORDESTE","MARANHÃO","570.9375671",14176,3561,3560,1,"4"
2107258,"NOVA COLINAS","NORDESTE","MARANHÃO","743.0854956",5021,2011,2007,4,"3.4"
2107308,"NOVA IORQUE","NORDESTE","MARANHÃO","978.3397485",4320,1962,1962,0,"3.2"
2107357,"NOVA OLINDA DO MARANHÃO","NORDESTE","MARANHÃO","2452.6150436",14314,5375,5368,7,"3.3"
2107407,"OLHO D'ÁGUA DAS CUNHÃS","NORDESTE","MARANHÃO","695.332757",17919,6822,6818,4,"3.2"
2107456,"OLINDA NOVA DO MARANHÃO","NORDESTE","MARANHÃO","199.8792324",13577,5040,5035,5,"3.3"
2107506,"PAÇO DO LUMIAR","NORDESTE","MARANHÃO","127.1928318",145643,60826,60805,21,"3"
2107605,"PALMEIRÂNDIA","NORDESTE","MARANHÃO","532.1622334",21059,7082,7079,3,"3.5"
2107704,"PARAIBANO","NORDESTE","MARANHÃO","530.5165818",18274,7653,7649,4,"3.1"
2107803,"PARNARAMA","NORDESTE","MARANHÃO","3245.5249465",31250,12308,12292,16,"3.3"
2107902,"PASSAGEM FRANCA","NORDESTE","MARANHÃO","1358.3271901",17220,7303,7296,7,"3.2"
2108009,"PASTOS BONS","NORDESTE","MARANHÃO","1635.1808247",18802,8144,8140,4,"3.3"
2108058,"PAULINO NEVES","NORDESTE","MARANHÃO","979.4818918",17056,5733,5728,5,"3.8"
2108108,"PAULO RAMOS","NORDESTE","MARANHÃO","1168.6087081",20341,7681,7679,2,"3.4"
2108207,"PEDREIRAS","NORDESTE","MARANHÃO","262.0658138",37050,14473,14463,10,"3"
2108256,"PEDRO DO ROSÁRIO","NORDESTE","MARANHÃO","1753.8673353",24320,7814,7807,7,"3.5"
2108306,"PENALVA","NORDESTE","MARANHÃO","800.9159446",32511,11592,11584,8,"3.4"
2108405,"PERI MIRIM","NORDESTE","MARANHÃO","397.9931833",11108,4613,4612,1,"2.9"
2108454,"PERITORÓ","NORDESTE","MARANHÃO","824.7207531",20479,7305,7301,4,"3.3"
2108504,"PINDARÉ-MIRIM","NORDESTE","MARANHÃO","268.2850191",31429,11028,11021,7,"3.3"
2108603,"PINHEIRO","NORDESTE","MARANHÃO","1512.9688164",84621,32003,31950,53,"3.2"
2108702,"PIO XII","NORDESTE","MARANHÃO","545.1401495",21886,8037,8026,11,"3.4"
2108801,"PIRAPEMAS","NORDESTE","MARANHÃO","688.7614932",17714,5774,5771,3,"3.4"
2108900,"POÇÃO DE PEDRAS","NORDESTE","MARANHÃO","990.4144846",17161,7490,7486,4,"3"
2109007,"PORTO FRANCO","NORDESTE","MARANHÃO","1420.5099073",23903,9624,9598,26,"3"
2109056,"PORTO RICO DO MARANHÃO","NORDESTE","MARANHÃO","244.9787495",5954,2197,2195,2,"3.2"
2109106,"PRESIDENTE DUTRA","NORDESTE","MARANHÃO","771.5739974",45155,17948,17927,21,"3.1"
2109205,"PRESIDENTE JUSCELINO","NORDESTE","MARANHÃO","355.5676304",11356,3867,3864,3,"3.6"
2109239,"PRESIDENTE MÉDICI","NORDESTE","MARANHÃO","437.6873614",4696,1807,1806,1,"3.4"
2109270,"PRESIDENTE SARNEY","NORDESTE","MARANHÃO","726.1758351",17511,6417,6415,2,"3.5"
2109304,"PRESIDENTE VARGAS","NORDESTE","MARANHÃO","460.0040369",10549,3476,3473,3,"3.4"
2109403,"PRIMEIRA CRUZ","NORDESTE","MARANHÃO","1337.1613785",13614,4567,4547,20,"3.8"
2109452,"RAPOSA","NORDESTE","MARANHÃO","79.2131771",30839,11745,11739,6,"3.2"
2109502,"RIACHÃO","NORDESTE","MARANHÃO","6402.8299701",22145,9558,9536,22,"3.1"
2109551,"RIBAMAR FIQUENE","NORDESTE","MARANHÃO","733.457789",7420,3243,3241,2,"3.1"
2109601,"ROSÁRIO","NORDESTE","MARANHÃO","647.998372",38475,14567,14544,23,"3.2"
2109700,"SAMBAÍBA","NORDESTE","MARANHÃO","2476.1316429",5568,2532,2532,0,"3.3"
2109759,"SANTA FILOMENA DO MARANHÃO","NORDESTE","MARANHÃO","623.2134502",6697,2653,2653,0,"3.3"
2109809,"SANTA HELENA","NORDESTE","MARANHÃO","2191.1638959",41561,12055,12048,7,"3.8"
2109908,"SANTA INÊS","NORDESTE","MARANHÃO","786.6887704",85014,32784,32754,30,"3.2"
2110005,"SANTA LUZIA","NORDESTE","MARANHÃO","4837.1684732",57635,23536,23511,25,"3.4"
2110039,"SANTA LUZIA DO PARUÁ","NORDESTE","MARANHÃO","1010.4828749",24307,8579,8568,11,"3.4"
2110104,"SANTA QUITÉRIA DO MARANHÃO","NORDESTE","MARANHÃO","1430.3299315",23957,7919,7915,4,"3.7"
2110203,"SANTA RITA","NORDESTE","MARANHÃO","756.7967971",37035,13149,13138,11,"3.3"
2110237,"SANTANA DO MARANHÃO","NORDESTE","MARANHÃO","932.0296653",10567,3737,3734,3,"3.6"
2110278,"SANTO AMARO DO MARANHÃO","NORDESTE","MARANHÃO","1582.8057239",13949,4546,4481,65,"3.9"
2110302,"SANTO ANTÔNIO DOS LOPES","NORDESTE","MARANHÃO","770.9226504",14304,5597,5581,16,"3.3"
2110401,"SÃO BENEDITO DO RIO PRETO","NORDESTE","MARANHÃO","931.4849942",18364,6217,6210,7,"3.7"
2110500,"SÃO BENTO","NORDESTE","MARANHÃO","456.9973161",46395,13594,13586,8,"3.9"
2110609,"SÃO BERNARDO","NORDESTE","MARANHÃO","1005.8238922",26943,9714,9703,11,"3.5"
2110658,"SÃO DOMINGOS DO AZEITÃO","NORDESTE","MARANHÃO","961.2494818",7992,3022,3017,5,"3.6"
2110708,"SÃO DOMINGOS DO MARANHÃO","NORDESTE","MARANHÃO","1151.9778813",34034,13694,13683,11,"3.2"
2110807,"SÃO FÉLIX DE BALSAS","NORDESTE","MARANHÃO","2032.5992842",4402,1949,1948,1,"3.1"
2110856,"SÃO FRANCISCO DO BREJÃO","NORDESTE","MARANHÃO","745.3573678",9051,3780,3777,3,"3.2"
2110906,"SÃO FRANCISCO DO MARANHÃO","NORDESTE","MARANHÃO","2284.2169032",12064,5186,5185,1,"3.2"
2111003,"SÃO JOÃO BATISTA","NORDESTE","MARANHÃO","649.9561296",18544,7048,7044,4,"3.1"
2111029,"SÃO JOÃO DO CARÚ","NORDESTE","MARANHÃO","910.0652375",12251,4205,4201,4,"3.7"
2111052,"SÃO JOÃO DO PARAÍSO","NORDESTE","MARANHÃO","2052.3281328",9904,4315,4314,1,"3.1"
2111078,"SÃO JOÃO DO SOTER","NORDESTE","MARANHÃO","1438.0662066",16889,6375,6371,4,"3.3"
2111102,"SÃO JOÃO DOS PATOS","NORDESTE","MARANHÃO","1483.2555386",25020,11364,11352,12,"3"
2111201,"SÃO JOSÉ DE RIBAMAR","NORDESTE","MARANHÃO","180.3631893",244579,102299,102279,20,"3"
2111250,"SÃO JOSÉ DOS BASÍLIOS","NORDESTE","MARANHÃO","353.7197013",6957,2608,2608,0,"3.3"
2111300,"SÃO LUÍS","NORDESTE","MARANHÃO","583.0630248",1037775,406974,406707,267,"3"
2111409,"SÃO LUÍS GONZAGA DO MARANHÃO","NORDESTE","MARANHÃO","909.1637673",17818,7188,7187,1,"3.2"
2111508,"SÃO MATEUS DO MARANHÃO","NORDESTE","MARANHÃO","800.044904",38829,14773,14763,10,"3.2"
2111532,"SÃO PEDRO DA ÁGUA BRANCA","NORDESTE","MARANHÃO","720.4608144",14338,4581,4557,24,"3.6"
2111573,"SÃO PEDRO DOS CRENTES","NORDESTE","MARANHÃO","979.914816",5783,2071,2067,4,"3.4"
2111607,"SÃO RAIMUNDO DAS MANGABEIRAS","NORDESTE","MARANHÃO","3524.5008374",18672,7501,7497,4,"3.2"
2111631,"SÃO RAIMUNDO DO DOCA BEZERRA","NORDESTE","MARANHÃO","419.550215",5650,2139,2136,3,"3.4"
2111672,"SÃO ROBERTO","NORDESTE","MARANHÃO","226.8107946",4544,1831,1831,0,"3.3"
2111706,"SÃO VICENTE FERRER","NORDESTE","MARANHÃO","393.9281359",19498,7567,7553,14,"3.1"
2111722,"SATUBINHA","NORDESTE","MARANHÃO","441.8106048",8784,3078,3077,1,"3.6"
2111748,"SENADOR ALEXANDRE COSTA","NORDESTE","MARANHÃO","426.4371372",10207,3951,3951,0,"3.4"
2111763,"SENADOR LA ROCQUE","NORDESTE","MARANHÃO","738.1873373",14700,6123,6119,4,"3.2"
2111789,"SERRANO DO MARANHÃO","NORDESTE","MARANHÃO","1165.3177209",10202,3953,3952,1,"3.2"
2111805,"SÍTIO NOVO","NORDESTE","MARANHÃO","3114.6827312",17074,6515,6514,1,"3.3"
2111904,"SUCUPIRA DO NORTE","NORDESTE","MARANHÃO","1074.4353692",10238,4346,4343,3,"3.3"
2111953,"SUCUPIRA DO RIACHÃO","NORDESTE","MARANHÃO","862.2258169",4985,2302,2302,0,"3.2"
2112001,"TASSO FRAGOSO","NORDESTE","MARANHÃO","4369.1588735",8862,3510,3506,4,"3.3"
2112100,"TIMBIRAS","NORDESTE","MARANHÃO","1486.5843423",26484,9533,9532,1,"3.5"
2112209,"TIMON","NORDESTE","MARANHÃO","1763.2199364",174465,68052,68004,48,"3.2"
2112233,"TRIZIDELA DO VALE","NORDESTE","MARANHÃO","291.6098515",22484,8626,8622,4,"3.1"
2112274,"TUFILÂNDIA","NORDESTE","MARANHÃO","270.9343172",5507,2053,2051,2,"3.5"
2112308,"TUNTUM","NORDESTE","MARANHÃO","3369.118796",36251,14550,14544,6,"3.2"
2112407,"TURIAÇU","NORDESTE","MARANHÃO","2622.2806435",37491,11177,11172,5,"3.7"
2112456,"TURILÂNDIA","NORDESTE","MARANHÃO","1507.6219919",31638,7729,7727,2,"4.4"
2112506,"TUTÓIA","NORDESTE","MARANHÃO","1566.0805084",53356,18615,18585,30,"3.6"
2112605,"URBANO SANTOS","NORDESTE","MARANHÃO","1707.6211765",32812,11217,11208,9,"3.8"
2112704,"VARGEM GRANDE","NORDESTE","MARANHÃO","1958.7023551",43261,15952,15949,3,"3.4"
2112803,"VIANA","NORDESTE","MARANHÃO","1166.7448532",51442,19228,19207,21,"3.3"
2112852,"VILA NOVA DOS MARTÍRIOS","NORDESTE","MARANHÃO","1190.007945",10362,4534,4520,14,"3.1"
2112902,"VITÓRIA DO MEARIM","NORDESTE","MARANHÃO","716.7192325",30805,11804,11793,11,"3.3"
2113009,"VITORINO FREIRE","NORDESTE","MARANHÃO","1193.385507",30845,11568,11559,9,"3.2"
2114007,"ZÉ DOCA","NORDESTE","MARANHÃO","2140.1087166",40801,16234,16209,25,"3.2"
2200053,"ACAUÃ","NORDESTE","PIAUÍ","1280.8381532",6420,3098,3098,0,"2.9"
2200103,"AGRICOLÂNDIA","NORDESTE","PIAUÍ","112.392067",4940,2286,2283,3,"2.9"
2200202,"ÁGUA BRANCA","NORDESTE","PIAUÍ","96.8424785",17573,7530,7524,6,"3"
2200251,"ALAGOINHA DO PIAUÍ","NORDESTE","PIAUÍ","535.8897605",6819,3826,3824,2,"2.6"
2200277,"ALEGRETE DO PIAUÍ","NORDESTE","PIAUÍ","243.7318782",4634,2169,2169,0,"2.9"
2200301,"ALTO LONGÁ","NORDESTE","PIAUÍ","1743.3306802",13479,6049,6048,1,"2.9"
2200400,"ALTOS","NORDESTE","PIAUÍ","957.2319598",47453,20938,20923,15,"3.1"
2200459,"ALVORADA DO GURGUÉIA","NORDESTE","PIAUÍ","2131.5058858",5322,2207,2205,2,"3.2"
2200509,"AMARANTE","NORDESTE","PIAUÍ","1152.1269495",17234,7313,7310,3,"3.1"
2200608,"ANGICAL DO PIAUÍ","NORDESTE","PIAUÍ","222.0083426",6827,3308,3302,6,"2.8"
2200707,"ANÍSIO DE ABREU","NORDESTE","PIAUÍ","337.8770016",9407,4465,4459,6,"2.9"
2200806,"ANTÔNIO ALMEIDA","NORDESTE","PIAUÍ","644.8002356",3152,1454,1449,5,"3"
2200905,"AROAZES","NORDESTE","PIAUÍ","821.2118568",5369,2417,2417,0,"3"
2200954,"AROEIRAS DO ITAIM","NORDESTE","PIAUÍ","316.2347274",2690,1271,1271,0,"2.9"
2201002,"ARRAIAL","NORDESTE","PIAUÍ","682.7266721",4520,2106,2104,2,"2.9"
2201051,"ASSUNÇÃO DO PIAUÍ","NORDESTE","PIAUÍ","1690.7033822",7452,4111,4111,0,"3.2"
2201101,"AVELINO LOPES","NORDESTE","PIAUÍ","1220.3713309",10866,5004,5001,3,"3"
2201150,"BAIXA GRANDE DO RIBEIRO","NORDESTE","PIAUÍ","7808.9152774",13272,5654,5602,52,"3.4"
2201176,"BARRA D'ALCÂNTARA","NORDESTE","PIAUÍ","263.9427405",3995,1959,1959,0,"2.7"
2201200,"BARRAS","NORDESTE","PIAUÍ","1722.5065489",47938,18024,18018,6,"3.3"
2201309,"BARREIRAS DO PIAUÍ","NORDESTE","PIAUÍ","2168.7129766",3264,1431,1431,0,"3.2"
2201408,"BARRO DURO","NORDESTE","PIAUÍ","159.4363958",6640,2860,2860,0,"3"
2201507,"BATALHA","NORDESTE","PIAUÍ","1589.0105264",26300,11099,11083,16,"3"
2201556,"BELA VISTA DO PIAUÍ","NORDESTE","PIAUÍ","499.0915921",4091,1607,1607,0,"3.3"
2201572,"BELÉM DO PIAUÍ","NORDESTE","PIAUÍ","243.2341547",3423,1583,1582,1,"3"
2201606,"BENEDITINOS","NORDESTE","PIAUÍ","937.0983868",9929,4742,4740,2,"2.8"
2201705,"BERTOLÍNIA","NORDESTE","PIAUÍ","1216.1159606",5562,2312,2309,3,"3.1"
2201739,"BETÂNIA DO PIAUÍ","NORDESTE","PIAUÍ","579.5763396",6220,3011,3006,5,"3"
2201770,"BOA HORA","NORDESTE","PIAUÍ","336.9542001",6902,2589,2587,2,"3.3"
2201804,"BOCAINA","NORDESTE","PIAUÍ","261.651224",4078,2533,2533,0,"2.6"
2201903,"BOM JESUS","NORDESTE","PIAUÍ","5471.0234086",28796,12197,12147,50,"3.2"
2201919,"BOM PRINCÍPIO DO PIAUÍ","NORDESTE","PIAUÍ","523.1417105",5636,2315,2315,0,"3.1"
2201929,"BONFIM DO PIAUÍ","NORDESTE","PIAUÍ","289.1486172",5913,2669,2668,1,"3"
2201945,"BOQUEIRÃO DO PIAUÍ","NORDESTE","PIAUÍ","269.7856263",6545,2573,2572,1,"3.1"
2201960,"BRASILEIRA","NORDESTE","PIAUÍ","880.8360925",8436,3719,3719,0,"3"
2201988,"BREJO DO PIAUÍ","NORDESTE","PIAUÍ","2267.3263415",3904,2002,2002,0,"2.8"
2202000,"BURITI DOS LOPES","NORDESTE","PIAUÍ","690.539858",19654,7628,7627,1,"3.2"
2202026,"BURITI DOS MONTES","NORDESTE","PIAUÍ","2437.3260944",7434,3457,3456,1,"3.1"
2202059,"CABECEIRAS DO PIAUÍ","NORDESTE","PIAUÍ","608.746954",10212,3885,3885,0,"3.2"
2202075,"CAJAZEIRAS DO PIAUÍ","NORDESTE","PIAUÍ","514.1059664",3108,1390,1385,5,"3"
2202083,"CAJUEIRO DA PRAIA","NORDESTE","PIAUÍ","271.1648218",7957,3608,3580,28,"3.2"
2202091,"CALDEIRÃO GRANDE DO PIAUÍ","NORDESTE","PIAUÍ","467.0823349",5503,2624,2617,7,"3"
2202109,"CAMPINAS DO PIAUÍ","NORDESTE","PIAUÍ","783.8428345",4938,2567,2567,0,"2.8"
2202117,"CAMPO ALEGRE DO FIDALGO","NORDESTE","PIAUÍ","657.7958707",4616,2384,2382,2,"2.9"
2202133,"CAMPO GRANDE DO PIAUÍ","NORDESTE","PIAUÍ","311.6824198",6020,2952,2949,3,"2.9"
2202174,"CAMPO LARGO DO PIAUÍ","NORDESTE","PIAUÍ","478.0779546",7419,2658,2657,1,"3.4"
2202208,"CAMPO MAIOR","NORDESTE","PIAUÍ","1680.8614135",45793,19523,19509,14,"2.9"
2202251,"CANAVIEIRA","NORDESTE","PIAUÍ","2165.2774256",3414,1807,1806,1,"3"
2202307,"CANTO DO BURITI","NORDESTE","PIAUÍ","4325.642855",19365,9330,9306,24,"2.8"
2202406,"CAPITÃO DE CAMPOS","NORDESTE","PIAUÍ","571.6580431",11100,4615,4610,5,"3.1"
2202455,"CAPITÃO GERVÁSIO OLIVEIRA","NORDESTE","PIAUÍ","1132.9950499",3974,2131,2131,0,"2.7"
2202505,"CARACOL","NORDESTE","PIAUÍ","1610.958784",10318,4510,4503,7,"3.1"
2202539,"CARAÚBAS DO PIAUÍ","NORDESTE","PIAUÍ","471.2164384",5630,2342,2339,3,"2.9"
2202554,"CARIDADE DO PIAUÍ","NORDESTE","PIAUÍ","498.7934458",5033,2280,2280,0,"3.1"
2202604,"CASTELO DO PIAUÍ","NORDESTE","PIAUÍ","2378.8470648",19288,8736,8731,5,"2.9"
2202653,"CAXINGÓ","NORDESTE","PIAUÍ","491.0929109",5496,2175,2173,2,"3.1"
2202703,"COCAL","NORDESTE","PIAUÍ","1294.1324846",28212,11670,11667,3,"3.2"
2202711,"COCAL DE TELHA","NORDESTE","PIAUÍ","310.2907046",4911,2222,2222,0,"3"
2202729,"COCAL DOS ALVES","NORDESTE","PIAUÍ","324.8557978",6386,2936,2934,2,"2.9"
2202737,"COIVARAS","NORDESTE","PIAUÍ","484.4600185",4117,1764,1764,0,"3.2"
2202752,"COLÔNIA DO GURGUÉIA","NORDESTE","PIAUÍ","429.5911019",6150,2845,2840,5,"3"
2202778,"COLÔNIA DO PIAUÍ","NORDESTE","PIAUÍ","950.1928591",6994,3238,3238,0,"3"
2202802,"CONCEIÇÃO DO CANINDÉ","NORDESTE","PIAUÍ","824.7291668",4932,2426,2424,2,"2.9"
2202851,"CORONEL JOSÉ DIAS","NORDESTE","PIAUÍ","1926.1028299",4250,2165,2162,3,"2.9"
2202901,"CORRENTE","NORDESTE","PIAUÍ","3048.7467629",27278,11533,11520,13,"3.2"
2203008,"CRISTALÂNDIA DO PIAUÍ","NORDESTE","PIAUÍ","1202.895982",7356,3208,3207,1,"3.2"
2203107,"CRISTINO CASTRO","NORDESTE","PIAUÍ","1845.6974184",10503,4409,4402,7,"3.2"
2203206,"CURIMATÁ","NORDESTE","PIAUÍ","2344.9487292",11270,5264,5253,11,"3.1"
2203230,"CURRAIS","NORDESTE","PIAUÍ","3156.6566949",4854,2221,2216,5,"3.3"
2203255,"CURRALINHOS","NORDESTE","PIAUÍ","345.8108638",4413,1973,1970,3,"3.1"
2203271,"CURRAL NOVO DO PIAUÍ","NORDESTE","PIAUÍ","755.251082",5073,2264,2263,1,"3.2"
2203305,"DEMERVAL LOBÃO","NORDESTE","PIAUÍ","216.8068222",16352,8100,8097,3,"3"
2203354,"DIRCEU ARCOVERDE","NORDESTE","PIAUÍ","1005.5712352",7054,3128,3123,5,"3.1"
2203404,"DOM EXPEDITO LOPES","NORDESTE","PIAUÍ","218.8078994",6320,2880,2879,1,"2.8"
2203420,"DOMINGOS MOURÃO","NORDESTE","PIAUÍ","848.7052026",4075,1859,1859,0,"3.1"
2203453,"DOM INOCÊNCIO","NORDESTE","PIAUÍ","3871.823583",9159,4516,4504,12,"2.9"
2203503,"ELESBÃO VELOSO","NORDESTE","PIAUÍ","1383.9755222",13607,6433,6428,5,"2.8"
2203602,"ELISEU MARTINS","NORDESTE","PIAUÍ","1097.7904332",4377,2184,2180,4,"2.9"
2203701,"ESPERANTINA","NORDESTE","PIAUÍ","908.7475511",40970,16255,16245,10,"3.1"
2203750,"FARTURA DO PIAUÍ","NORDESTE","PIAUÍ","713.0463249",5284,2350,2349,1,"3"
2203800,"FLORES DO PIAUÍ","NORDESTE","PIAUÍ","946.7188179",4414,2261,2260,1,"2.8"
2203859,"FLORESTA DO PIAUÍ","NORDESTE","PIAUÍ","223.1991454",2333,1222,1221,1,"2.7"
2203909,"FLORIANO","NORDESTE","PIAUÍ","3407.9786496",62036,26074,26041,33,"2.9"
2204006,"FRANCINÓPOLIS","NORDESTE","PIAUÍ","268.7041058",4505,2458,2454,4,"2.7"
2204105,"FRANCISCO AYRES","NORDESTE","PIAUÍ","656.4752435",4412,2178,2177,1,"2.9"
2204154,"FRANCISCO MACEDO","NORDESTE","PIAUÍ","179.2448986",2929,1381,1380,1,"2.9"
2204204,"FRANCISCO SANTOS","NORDESTE","PIAUÍ","492.1909438",8237,4438,4436,2,"2.8"
2204303,"FRONTEIRAS","NORDESTE","PIAUÍ","777.1791402",10259,5032,5025,7,"2.9"
2204352,"GEMINIANO","NORDESTE","PIAUÍ","440.6060719",5445,2703,2703,0,"2.8"
2204402,"GILBUÉS","NORDESTE","PIAUÍ","3495.69221",10892,4567,4562,5,"3.2"
2204501,"GUADALUPE","NORDESTE","PIAUÍ","1026.5385152",10270,4171,4156,15,"3.1"
2204550,"GUARIBAS","NORDESTE","PIAUÍ","3118.23106",4276,1945,1943,2,"3.3"
2204600,"HUGO NAPOLEÃO","NORDESTE","PIAUÍ","224.5729744",3518,1736,1736,0,"3"
2204659,"ILHA GRANDE","NORDESTE","PIAUÍ","129.6957408",9274,3271,3271,0,"3.3"
2204709,"INHUMA","NORDESTE","PIAUÍ","978.2216401",14958,7163,7160,3,"2.9"
2204808,"IPIRANGA DO PIAUÍ","NORDESTE","PIAUÍ","529.4167769",9420,4225,4219,6,"3"
2204907,"ISAÍAS COELHO","NORDESTE","PIAUÍ","800.6876204",7774,3675,3675,0,"3"
2205003,"ITAINÓPOLIS","NORDESTE","PIAUÍ","827.6203914",10790,5630,5626,4,"2.7"
2205102,"ITAUEIRA","NORDESTE","PIAUÍ","2554.1792695",10323,4911,4905,6,"2.8"
2205151,"JACOBINA DO PIAUÍ","NORDESTE","PIAUÍ","1333.7961377",5613,3178,3175,3,"2.9"
2205201,"JAICÓS","NORDESTE","PIAUÍ","866.7881654",17527,9459,9454,5,"2.9"
2205250,"JARDIM DO MULATO","NORDESTE","PIAUÍ","510.2259409",4180,1909,1909,0,"2.9"
2205276,"JATOBÁ DO PIAUÍ","NORDESTE","PIAUÍ","650.3927852",4494,1921,1920,1,"3"
2205300,"JERUMENHA","NORDESTE","PIAUÍ","1865.9396071",4497,2090,2083,7,"3"
2205359,"JOÃO COSTA","NORDESTE","PIAUÍ","1800.230277",2970,1459,1457,2,"3"
2205409,"JOAQUIM PIRES","NORDESTE","PIAUÍ","740.5610421",13886,5128,5128,0,"3.2"
2205458,"JOCA MARQUES","NORDESTE","PIAUÍ","169.0053669",5394,1988,1988,0,"3.3"
2205508,"JOSÉ DE FREITAS","NORDESTE","PIAUÍ","1538.1720684",42559,16955,16949,6,"3.2"
2205516,"JUAZEIRO DO PIAUÍ","NORDESTE","PIAUÍ","935.4039851",5214,2475,2472,3,"2.9"
2205524,"JÚLIO BORGES","NORDESTE","PIAUÍ","1283.9161033",5388,2479,2476,3,"3.2"
2205532,"JUREMA","NORDESTE","PIAUÍ","1271.8809421",4425,2257,2257,0,"2.9"
2205540,"LAGOINHA DO PIAUÍ","NORDESTE","PIAUÍ","67.6489662",2939,1479,1479,0,"2.9"
2205557,"LAGOA ALEGRE","NORDESTE","PIAUÍ","394.2051832",8256,3337,3333,4,"3.3"
2205565,"LAGOA DO BARRO DO PIAUÍ","NORDESTE","PIAUÍ","1331.0253285",4995,2535,2531,4,"3.1"
2205573,"LAGOA DE SÃO FRANCISCO","NORDESTE","PIAUÍ","155.8601055",6331,2547,2544,3,"3.2"
2205581,"LAGOA DO PIAUÍ","NORDESTE","PIAUÍ","427.840712",4810,2322,2322,0,"3"
2205599,"LAGOA DO SÍTIO","NORDESTE","PIAUÍ","805.017807",4520,2632,2632,0,"2.9"
2205607,"LANDRI SALES","NORDESTE","PIAUÍ","1088.5830943",5213,2687,2686,1,"2.9"
2205706,"LUÍS CORREIA","NORDESTE","PIAUÍ","1074.1316104",30641,15845,15763,82,"3.3"
2205805,"LUZILÂNDIA","NORDESTE","PIAUÍ","705.5993262",25375,9501,9495,6,"3.2"
2205854,"MADEIRO","NORDESTE","PIAUÍ","178.8424631",8032,2590,2589,1,"3.5"
2205904,"MANOEL EMÍDIO","NORDESTE","PIAUÍ","1620.4133932",5209,2332,2332,0,"3"
2205953,"MARCOLÂNDIA","NORDESTE","PIAUÍ","136.7860931",8533,3591,3586,5,"3"
2206001,"MARCOS PARENTE","NORDESTE","PIAUÍ","677.4156334",4724,2146,2144,2,"3.1"
2206050,"MASSAPÊ DO PIAUÍ","NORDESTE","PIAUÍ","530.1690517",5218,2506,2506,0,"3"
2206100,"MATIAS OLÍMPIO","NORDESTE","PIAUÍ","226.7847085",10641,3928,3926,2,"3.3"
2206209,"MIGUEL ALVES","NORDESTE","PIAUÍ","1392.1228946",32150,11158,11152,6,"3.5"
2206308,"MIGUEL LEÃO","NORDESTE","PIAUÍ","93.4119257",1318,562,559,3,"3.2"
2206357,"MILTON BRANDÃO","NORDESTE","PIAUÍ","1309.1278421",6542,3031,3030,1,"3.1"
2206407,"MONSENHOR GIL","NORDESTE","PIAUÍ","567.859157",10255,4730,4727,3,"2.9"
2206506,"MONSENHOR HIPÓLITO","NORDESTE","PIAUÍ","401.5675574",7577,3965,3965,0,"2.8"
2206605,"MONTE ALEGRE DO PIAUÍ","NORDESTE","PIAUÍ","2417.3820478",10660,4372,4371,1,"3.3"
2206654,"MORRO CABEÇA NO TEMPO","NORDESTE","PIAUÍ","2207.657997",4377,2102,2092,10,"3.2"
2206670,"MORRO DO CHAPÉU DO PIAUÍ","NORDESTE","PIAUÍ","328.4081962",6425,2577,2574,3,"3.1"
2206696,"MURICI DOS PORTELAS","NORDESTE","PIAUÍ","475.7198425",9797,3500,3498,2,"3.3"
2206704,"NAZARÉ DO PIAUÍ","NORDESTE","PIAUÍ","1315.8407091",6665,3268,3262,6,"2.9"
2206720,"NAZÁRIA","NORDESTE","PIAUÍ","362.3759228",10262,4974,4973,1,"3.1"
2206753,"NOSSA SENHORA DE NAZARÉ","NORDESTE","PIAUÍ","356.8720783",5228,2231,2231,0,"3.1"
2206803,"NOSSA SENHORA DOS REMÉDIOS","NORDESTE","PIAUÍ","357.8959058",8525,3099,3098,1,"3.3"
2206902,"NOVO ORIENTE DO PIAUÍ","NORDESTE","PIAUÍ","525.9055887",6097,2972,2971,1,"2.7"
2206951,"NOVO SANTO ANTÔNIO","NORDESTE","PIAUÍ","443.8722432",2827,1561,1560,1,"2.8"
2207009,"OEIRAS","NORDESTE","PIAUÍ","2703.137749",38161,18074,18060,14,"2.8"
2207108,"OLHO D'ÁGUA DO PIAUÍ","NORDESTE","PIAUÍ","183.6033144",2637,1209,1209,0,"2.9"
2207207,"PADRE MARCOS","NORDESTE","PIAUÍ","278.6957817",6382,3409,3408,1,"2.7"
2207306,"PAES LANDIM","NORDESTE","PIAUÍ","401.3784029",4088,1941,1941,0,"3"
2207355,"PAJEÚ DO PIAUÍ","NORDESTE","PIAUÍ","986.9612262",3000,1719,1719,0,"2.7"
2207405,"PALMEIRA DO PIAUÍ","NORDESTE","PIAUÍ","2024.0205422",4952,2054,2052,2,"3.1"
2207504,"PALMEIRAIS","NORDESTE","PIAUÍ","1493.76425",13264,6152,6148,4,"3.1"
2207553,"PAQUETÁ","NORDESTE","PIAUÍ","432.5720226",3813,1841,1841,0,"3"
2207603,"PARNAGUÁ","NORDESTE","PIAUÍ","3428.8107209",10103,3963,3962,1,"3.3"
2207702,"PARNAÍBA","NORDESTE","PIAUÍ","436.9066712",162159,64580,64477,103,"3.1"
2207751,"PASSAGEM FRANCA DO PIAUÍ","NORDESTE","PIAUÍ","643.2263759",4135,1633,1629,4,"3.4"
2207777,"PATOS DO PIAUÍ","NORDESTE","PIAUÍ","801.4032157",5425,3163,3160,3,"2.6"
2207793,"PAU D'ARCO DO PIAUÍ","NORDESTE","PIAUÍ","430.0230875",3880,1908,1908,0,"3"
2207801,"PAULISTANA","NORDESTE","PIAUÍ","1941.1112895",21055,10470,10459,11,"2.9"
2207850,"PAVUSSU","NORDESTE","PIAUÍ","1090.6967569",3628,1918,1917,1,"2.8"
2207900,"PEDRO II","NORDESTE","PIAUÍ","1544.4126148",37894,16485,16471,14,"3.1"
2207934,"PEDRO LAURENTINO","NORDESTE","PIAUÍ","870.6132053",2458,1158,1157,1,"3"
2207959,"NOVA SANTA RITA","NORDESTE","PIAUÍ","909.7342458",4076,1907,1907,0,"3"
2208007,"PICOS","NORDESTE","PIAUÍ","577.2837471",83090,36224,36185,39,"2.9"
2208106,"PIMENTEIRAS","NORDESTE","PIAUÍ","4562.5800876",11341,6168,6166,2,"2.9"
2208205,"PIO IX","NORDESTE","PIAUÍ","1948.1417733",17613,9013,9005,8,"2.9"
2208304,"PIRACURUCA","NORDESTE","PIAUÍ","2368.9356716",28846,13386,13375,11,"2.9"
2208403,"PIRIPIRI","NORDESTE","PIAUÍ","1407.1915083",65538,26741,26723,18,"3"
2208502,"PORTO","NORDESTE","PIAUÍ","253.1130106",12052,4062,4058,4,"3.6"
2208551,"PORTO ALEGRE DO PIAUÍ","NORDESTE","PIAUÍ","1168.043494",2364,1057,1053,4,"3.1"
2208601,"PRATA DO PIAUÍ","NORDESTE","PIAUÍ","196.7865752",3042,1466,1466,0,"2.8"
2208650,"QUEIMADA NOVA","NORDESTE","PIAUÍ","1283.3692168",8738,4106,4098,8,"3"
2208700,"REDENÇÃO DO GURGUÉIA","NORDESTE","PIAUÍ","2470.531428",8394,3399,3395,4,"3.3"
2208809,"REGENERAÇÃO","NORDESTE","PIAUÍ","1251.3210005",17133,7755,7751,4,"3"
2208858,"RIACHO FRIO","NORDESTE","PIAUÍ","2220.598389",4165,2003,2003,0,"3.2"
2208874,"RIBEIRA DO PIAUÍ","NORDESTE","PIAUÍ","1012.4794934",4055,2119,2119,0,"2.9"
2208908,"RIBEIRO GONÇALVES","NORDESTE","PIAUÍ","3987.1470057",6164,2758,2726,32,"3.3"
2209005,"RIO GRANDE DO PIAUÍ","NORDESTE","PIAUÍ","635.9526395",5801,3332,3332,0,"2.7"
2209104,"SANTA CRUZ DO PIAUÍ","NORDESTE","PIAUÍ","582.6581488",5831,2591,2590,1,"3"
2209153,"SANTA CRUZ DOS MILAGRES","NORDESTE","PIAUÍ","978.5464712",3435,1912,1908,4,"2.9"
2209203,"SANTA FILOMENA","NORDESTE","PIAUÍ","5293.6926229",6087,2577,2576,1,"3.3"
2209302,"SANTA LUZ","NORDESTE","PIAUÍ","1185.3983757",5336,2577,2575,2,"3.1"
2209351,"SANTANA DO PIAUÍ","NORDESTE","PIAUÍ","112.1890851",4125,1815,1815,0,"2.9"
2209377,"SANTA ROSA DO PIAUÍ","NORDESTE","PIAUÍ","338.3362159",4650,2328,2325,3,"2.7"
2209401,"SANTO ANTÔNIO DE LISBOA","NORDESTE","PIAUÍ","385.2856704",5839,3031,3029,2,"2.8"
2209450,"SANTO ANTÔNIO DOS MILAGRES","NORDESTE","PIAUÍ","33.6403227",2138,792,792,0,"3.5"
2209500,"SANTO INÁCIO DO PIAUÍ","NORDESTE","PIAUÍ","852.106054",3646,1864,1863,1,"2.7"
2209559,"SÃO BRAZ DO PIAUÍ","NORDESTE","PIAUÍ","656.042399",4358,2364,2363,1,"2.9"
2209609,"SÃO FÉLIX DO PIAUÍ","NORDESTE","PIAUÍ","627.0333549",2842,1520,1519,1,"2.8"
2209658,"SÃO FRANCISCO DE ASSIS DO PIAUÍ","NORDESTE","PIAUÍ","1072.3113071",5572,2589,2586,3,"3"
2209708,"SÃO FRANCISCO DO PIAUÍ","NORDESTE","PIAUÍ","1341.4506638",5392,3086,3086,0,"2.6"
2209757,"SÃO GONÇALO DO GURGUÉIA","NORDESTE","PIAUÍ","1385.2545874",2947,1548,1546,2,"3.2"
2209807,"SÃO GONÇALO DO PIAUÍ","NORDESTE","PIAUÍ","150.4950281",4837,2084,2084,0,"3.1"
2209856,"SÃO JOÃO DA CANABRAVA","NORDESTE","PIAUÍ","480.5370713",4242,2358,2358,0,"2.7"
2209872,"SÃO JOÃO DA FRONTEIRA","NORDESTE","PIAUÍ","817.1105189",5522,2534,2534,0,"2.9"
2209906,"SÃO JOÃO DA SERRA","NORDESTE","PIAUÍ","994.2236978",6114,3178,3173,5,"2.8"
2209955,"SÃO JOÃO DA VARJOTA","NORDESTE","PIAUÍ","394.4558144",4383,2067,2065,2,"3"
2209971,"SÃO JOÃO DO ARRAIAL","NORDESTE","PIAUÍ","213.376558",8186,3429,3428,1,"3.2"
2210003,"SÃO JOÃO DO PIAUÍ","NORDESTE","PIAUÍ","1527.4968387",21421,9739,9728,11,"3"
2210052,"SÃO JOSÉ DO DIVINO","NORDESTE","PIAUÍ","319.3672281",4841,2191,2191,0,"2.9"
2210102,"SÃO JOSÉ DO PEIXE","NORDESTE","PIAUÍ","1287.1736567",3297,1938,1937,1,"2.8"
2210201,"SÃO JOSÉ DO PIAUÍ","NORDESTE","PIAUÍ","373.3473922",6597,3919,3918,1,"2.9"
2210300,"SÃO JULIÃO","NORDESTE","PIAUÍ","291.0892313",6025,3370,3369,1,"2.7"
2210359,"SÃO LOURENÇO DO PIAUÍ","NORDESTE","PIAUÍ","673.821617",4410,2151,2151,0,"3"
2210375,"SÃO LUIS DO PIAUÍ","NORDESTE","PIAUÍ","217.9241571",2309,1197,1197,0,"2.8"
2210383,"SÃO MIGUEL DA BAIXA GRANDE","NORDESTE","PIAUÍ","444.5282932",2269,1137,1137,0,"2.8"
2210391,"SÃO MIGUEL DO FIDALGO","NORDESTE","PIAUÍ","813.4438724",2829,1359,1358,1,"3"
2210409,"SÃO MIGUEL DO TAPUIO","NORDESTE","PIAUÍ","4988.9730675",17554,8292,8290,2,"3"
2210508,"SÃO PEDRO DO PIAUÍ","NORDESTE","PIAUÍ","518.2878542",13755,5547,5544,3,"3.1"
2210607,"SÃO RAIMUNDO NONATO","NORDESTE","PIAUÍ","2415.2875518",38934,17600,17580,20,"3"
2210623,"SEBASTIÃO BARROS","NORDESTE","PIAUÍ","893.4884296",3202,1387,1387,0,"3.3"
2210631,"SEBASTIÃO LEAL","NORDESTE","PIAUÍ","3148.8573097",4446,2107,2100,7,"3.1"
2210656,"SIGEFREDO PACHECO","NORDESTE","PIAUÍ","1031.1009542",9460,4362,4361,1,"2.9"
2210706,"SIMÕES","NORDESTE","PIAUÍ","1076.0549991",14350,6165,6162,3,"3.1"
2210805,"SIMPLÍCIO MENDES","NORDESTE","PIAUÍ","1360.0279118",13870,5739,5737,2,"2.9"
2210904,"SOCORRO DO PIAUÍ","NORDESTE","PIAUÍ","761.8538594",4141,2110,2108,2,"2.9"
2210938,"SUSSUAPARA","NORDESTE","PIAUÍ","205.1941788",6220,2916,2916,0,"2.8"
2210953,"TAMBORIL DO PIAUÍ","NORDESTE","PIAUÍ","1587.2959646",2949,1569,1569,0,"2.9"
2210979,"TANQUE DO PIAUÍ","NORDESTE","PIAUÍ","398.0069024",2316,1488,1486,2,"2.7"
2211001,"TERESINA","NORDESTE","PIAUÍ","1391.292688",866300,355470,355086,384,"3.1"
2211100,"UNIÃO","NORDESTE","PIAUÍ","1170.7420962",46119,17499,17491,8,"3.3"
2211209,"URUÇUÍ","NORDESTE","PIAUÍ","8413.0163888",25203,10089,10061,28,"3.3"
2211308,"VALENÇA DO PIAUÍ","NORDESTE","PIAUÍ","1333.7224331",22279,10429,10425,4,"2.8"
2211357,"VÁRZEA BRANCA","NORDESTE","PIAUÍ","450.4292905",5055,2230,2229,1,"3"
2211407,"VÁRZEA GRANDE","NORDESTE","PIAUÍ","236.4527137",4417,2446,2445,1,"2.7"
2211506,"VERA MENDES","NORDESTE","PIAUÍ","341.9741524",3185,1784,1784,0,"2.6"
2211605,"VILA NOVA DO PIAUÍ","NORDESTE","PIAUÍ","221.6265676",2935,1600,1600,0,"2.7"
2211704,"WALL FERRAZ","NORDESTE","PIAUÍ","270.4267402",4059,1902,1902,0,"2.9"
2300101,"ABAIARA","NORDESTE","CEARÁ","180.8333446",10038,4358,4358,0,"2.9"
2300150,"ACARAPE","NORDESTE","CEARÁ","130.0024383",14027,5447,5446,1,"3.2"
2300200,"ACARAÚ","NORDESTE","CEARÁ","842.4703623",65264,26163,26129,34,"3.1"
2300309,"ACOPIARA","NORDESTE","CEARÁ","2254.2794392",44962,22529,22523,6,"2.7"
2300408,"AIUABA","NORDESTE","CEARÁ","2438.5627754",14076,7059,7059,0,"2.9"
2300507,"ALCÂNTARAS","NORDESTE","CEARÁ","135.7599073",11369,4994,4992,2,"3"
2300606,"ALTANEIRA","NORDESTE","CEARÁ","72.6753876",6782,3182,3178,4,"2.7"
2300705,"ALTO SANTO","NORDESTE","CEARÁ","1147.2084115",14155,6549,6544,5,"2.8"
2300754,"AMONTADA","NORDESTE","CEARÁ","1175.0442097",42156,17043,17017,26,"3.2"
2300804,"ANTONINA DO NORTE","NORDESTE","CEARÁ","259.7058585",7245,3519,3518,1,"2.8"
2300903,"APUIARÉS","NORDESTE","CEARÁ","543.980446",12928,6730,6726,4,"2.8"
2301000,"AQUIRAZ","NORDESTE","CEARÁ","480.2361157",80645,46344,46057,287,"2.9"
2301109,"ARACATI","NORDESTE","CEARÁ","1227.1973164",75113,33567,33485,82,"2.9"
2301208,"ARACOIABA","NORDESTE","CEARÁ","643.9875961",25553,11984,11971,13,"2.9"
2301257,"ARARENDÁ","NORDESTE","CEARÁ","342.3014358",11096,4842,4840,2,"2.8"
2301307,"ARARIPE","NORDESTE","CEARÁ","1097.3395768",19783,9391,9389,2,"2.9"
2301406,"ARATUBA","NORDESTE","CEARÁ","119.7580356",11224,4848,4848,0,"3.1"
2301505,"ARNEIROZ","NORDESTE","CEARÁ","1068.437493",7429,3488,3487,1,"2.8"
2301604,"ASSARÉ","NORDESTE","CEARÁ","1155.123881",21697,10694,10694,0,"2.8"
2301703,"AURORA","NORDESTE","CEARÁ","885.870236",23714,11327,11323,4,"2.8"
2301802,"BAIXIO","NORDESTE","CEARÁ","145.5561211",5704,2556,2556,0,"2.8"
2301851,"BANABUIÚ","NORDESTE","CEARÁ","1080.9859447",17195,6940,6936,4,"3.1"
2301901,"BARBALHA","NORDESTE","CEARÁ","608.1582407",75033,29531,29511,20,"3.1"
2301950,"BARREIRA","NORDESTE","CEARÁ","260.0028413",22392,9953,9937,16,"3"
2302008,"BARRO","NORDESTE","CEARÁ","711.346388",19381,9074,9071,3,"2.8"
2302057,"BARROQUINHA","NORDESTE","CEARÁ","385.583541",14567,6702,6699,3,"3.1"
2302107,"BATURITÉ","NORDESTE","CEARÁ","314.0748937",35218,14907,14895,12,"3"
2302206,"BEBERIBE","NORDESTE","CEARÁ","1596.7513276",53114,28351,28309,42,"2.9"
2302305,"BELA CRUZ","NORDESTE","CEARÁ","842.1064168",32775,13123,13118,5,"3"
2302404,"BOA VIAGEM","NORDESTE","CEARÁ","2835.0372253",50411,24740,24731,9,"2.8"
2302503,"BREJO SANTO","NORDESTE","CEARÁ","654.6580217",51090,19061,19046,15,"3"
2302602,"CAMOCIM","NORDESTE","CEARÁ","1120.4492617",62326,25570,25545,25,"3.1"
2302701,"CAMPOS SALES","NORDESTE","CEARÁ","1082.5816527",25135,12662,12654,8,"2.8"
2302800,"CANINDÉ","NORDESTE","CEARÁ","3032.3904093",74174,33619,33566,53,"2.9"
2302909,"CAPISTRANO","NORDESTE","CEARÁ","226.5486822",17254,7639,7637,2,"2.9"
2303006,"CARIDADE","NORDESTE","CEARÁ","926.2714704",16377,7256,7251,5,"3.1"
2303105,"CARIRÉ","NORDESTE","CEARÁ","755.5972484",17632,8104,8104,0,"2.9"
2303204,"CARIRIAÇU","NORDESTE","CEARÁ","634.1788301",26320,12607,12602,5,"3"
2303303,"CARIÚS","NORDESTE","CEARÁ","1036.4167476",17015,8244,8244,0,"2.7"
2303402,"CARNAUBAL","NORDESTE","CEARÁ","363.2200929",17210,7411,7408,3,"3"
2303501,"CASCAVEL","NORDESTE","CEARÁ","838.1146615",72720,34132,34113,19,"2.9"
2303600,"CATARINA","NORDESTE","CEARÁ","488.1525644",10243,4905,4902,3,"2.8"
2303659,"CATUNDA","NORDESTE","CEARÁ","784.0217041",10444,4215,4210,5,"3"
2303709,"CAUCAIA","NORDESTE","CEARÁ","1223.2457767",355679,160137,159999,138,"2.9"
2303808,"CEDRO","NORDESTE","CEARÁ","729.9703389",22344,10461,10455,6,"2.8"
2303907,"CHAVAL","NORDESTE","CEARÁ","237.2476004",12462,5045,5042,3,"3.2"
2303931,"CHORÓ","NORDESTE","CEARÁ","815.2675297",12113,5064,5064,0,"3"
2303956,"CHOROZINHO","NORDESTE","CEARÁ","296.4307122",20163,9222,9221,1,"2.8"
2304004,"COREAÚ","NORDESTE","CEARÁ","750.3326292",20953,9780,9778,2,"3"
2304103,"CRATEÚS","NORDESTE","CEARÁ","2981.4593752",76390,34293,34279,14,"2.8"
2304202,"CRATO","NORDESTE","CEARÁ","1138.1498172",131050,56702,56671,31,"2.9"
2304236,"CROATÁ","NORDESTE","CEARÁ","696.3484531",17481,8493,8484,9,"2.9"
2304251,"CRUZ","NORDESTE","CEARÁ","335.9210019",29761,13842,13752,90,"2.9"
2304269,"DEPUTADO IRAPUAN PINHEIRO","NORDESTE","CEARÁ","471.1336286",8932,4054,4049,5,"2.7"
2304277,"ERERÉ","NORDESTE","CEARÁ","362.9058584",6474,2989,2987,2,"2.9"
2304285,"EUSÉBIO","NORDESTE","CEARÁ","78.8180279",74170,29417,29409,8,"3"
2304301,"FARIAS BRITO","NORDESTE","CEARÁ","530.5403968",18217,8656,8655,1,"2.8"
2304350,"FORQUILHA","NORDESTE","CEARÁ","568.7775609",24173,9511,9511,0,"3"
2304400,"FORTALEZA","NORDESTE","CEARÁ","312.3527831",2428708,1034611,1034146,465,"2.8"
2304459,"FORTIM","NORDESTE","CEARÁ","285.0236561",17294,7741,7719,22,"2.9"
2304509,"FRECHEIRINHA","NORDESTE","CEARÁ","210.2838935",15657,7074,7071,3,"2.9"
2304608,"GENERAL SAMPAIO","NORDESTE","CEARÁ","230.370576",6734,3020,3020,0,"3.1"
2304657,"GRAÇA","NORDESTE","CEARÁ","258.9427246",13801,6473,6471,2,"2.9"
2304707,"GRANJA","NORDESTE","CEARÁ","2663.1761259",53344,23704,23692,12,"3.1"
2304806,"GRANJEIRO","NORDESTE","CEARÁ","111.5276837",4841,2019,2019,0,"3.1"
2304905,"GROAÍRAS","NORDESTE","CEARÁ","155.6807531",10910,4896,4890,6,"2.7"
2304954,"GUAIÚBA","NORDESTE","CEARÁ","256.0526673",24325,9668,9666,2,"3.1"
2305001,"GUARACIABA DO NORTE","NORDESTE","CEARÁ","624.6056634",42053,17013,16997,16,"3.1"
2305100,"GUARAMIRANGA","NORDESTE","CEARÁ","90.81657",5654,3389,3383,6,"2.9"
2305209,"HIDROLÂNDIA","NORDESTE","CEARÁ","926.5921335",17855,8332,8329,3,"2.8"
2305233,"HORIZONTE","NORDESTE","CEARÁ","160.5568008",74755,31342,31336,6,"2.9"
2305266,"IBARETAMA","NORDESTE","CEARÁ","879.2546857",11956,5255,5252,3,"3"
2305308,"IBIAPINA","NORDESTE","CEARÁ","414.0924052",23965,9717,9714,3,"3"
2305332,"IBICUITINGA","NORDESTE","CEARÁ","423.8562788",11611,5176,5169,7,"2.8"
2305357,"ICAPUÍ","NORDESTE","CEARÁ","421.4403056",21433,11076,11020,56,"3"
2305407,"ICÓ","NORDESTE","CEARÁ","1865.8621717",62642,28823,28813,10,"2.9"
2305506,"IGUATU","NORDESTE","CEARÁ","992.2075806",98064,44117,44106,11,"2.8"
2305605,"INDEPENDÊNCIA","NORDESTE","CEARÁ","3222.3805672",24024,11381,11378,3,"2.8"
2305654,"IPAPORANGA","NORDESTE","CEARÁ","704.7731529",11575,5448,5446,2,"2.7"
2305704,"IPAUMIRIM","NORDESTE","CEARÁ","276.5080152",12083,5541,5532,9,"3"
2305803,"IPU","NORDESTE","CEARÁ","626.0491525",41081,17798,17789,9,"2.9"
2305902,"IPUEIRAS","NORDESTE","CEARÁ","1483.2585192",36798,18039,18035,4,"2.8"
2306009,"IRACEMA","NORDESTE","CEARÁ","839.1739725",14001,6066,6064,2,"2.9"
2306108,"IRAUÇUBA","NORDESTE","CEARÁ","1466.4122242",23915,9690,9687,3,"3.3"
2306207,"ITAIÇABA","NORDESTE","CEARÁ","213.6034484",7536,3944,3941,3,"2.7"
2306256,"ITAITINGA","NORDESTE","CEARÁ","153.6859229",64650,24423,24402,21,"2.9"
2306306,"ITAPAJÉ","NORDESTE","CEARÁ","432.1877327",46426,19441,19439,2,"3"
2306405,"ITAPIPOCA","NORDESTE","CEARÁ","1600.3584281",131123,53600,53576,24,"3.2"
2306504,"ITAPIÚNA","NORDESTE","CEARÁ","593.2309408",17841,7550,7547,3,"2.9"
2306553,"ITAREMA","NORDESTE","CEARÁ","714.8329754",42957,15869,15836,33,"3.3"
2306603,"ITATIRA","NORDESTE","CEARÁ","829.6257561",20424,9286,9283,3,"3.1"
2306702,"JAGUARETAMA","NORDESTE","CEARÁ","1826.8256939",17232,7150,7150,0,"2.8"
2306801,"JAGUARIBARA","NORDESTE","CEARÁ","622.9630427",10356,4267,4257,10,"3.1"
2306900,"JAGUARIBE","NORDESTE","CEARÁ","1877.0624976",33726,15444,15439,5,"2.7"
2307007,"JAGUARUANA","NORDESTE","CEARÁ","854.3624347",31701,14412,14408,4,"2.7"
2307106,"JARDIM","NORDESTE","CEARÁ","544.9798415",27411,11454,11453,1,"3.1"
2307205,"JATI","NORDESTE","CEARÁ","368.3594818",7861,3467,3461,6,"3"
2307254,"JIJOCA DE JERICOACOARA","NORDESTE","CEARÁ","209.0290314",25555,11733,11470,263,"2.9"
2307304,"JUAZEIRO DO NORTE","NORDESTE","CEARÁ","258.7880589",286120,113276,113033,243,"2.9"
2307403,"JUCÁS","NORDESTE","CEARÁ","940.3358682",23922,10546,10538,8,"2.9"
2307502,"LAVRAS DA MANGABEIRA","NORDESTE","CEARÁ","945.2626618",30802,13410,13402,8,"2.9"
2307601,"LIMOEIRO DO NORTE","NORDESTE","CEARÁ","744.5248362",59560,26927,26919,8,"2.8"
2307635,"MADALENA","NORDESTE","CEARÁ","997.7808045",16896,7094,7091,3,"3"
2307650,"MARACANAÚ","NORDESTE","CEARÁ","105.0841444",234509,95409,95388,21,"2.9"
2307700,"MARANGUAPE","NORDESTE","CEARÁ","583.5053776",105093,42065,42049,16,"3"
2307809,"MARCO","NORDESTE","CEARÁ","573.6099634",25799,9524,9516,8,"3.4"
2307908,"MARTINÓPOLE","NORDESTE","CEARÁ","303.4453992",10846,4723,4722,1,"2.9"
2308005,"MASSAPÊ","NORDESTE","CEARÁ","567.7802626",37697,15331,15323,8,"3.1"
2308104,"MAURITI","NORDESTE","CEARÁ","1079.0106128",45561,19603,19593,10,"3.1"
2308203,"MERUOCA","NORDESTE","CEARÁ","151.6509021",15157,7137,7123,14,"3.1"
2308302,"MILAGRES","NORDESTE","CEARÁ","579.0965513",25900,11325,11320,5,"3"
2308351,"MILHÃ","NORDESTE","CEARÁ","502.1374189",14123,5785,5783,2,"3"
2308377,"MIRAÍMA","NORDESTE","CEARÁ","708.6783486",14196,5232,5219,13,"3.3"
2308401,"MISSÃO VELHA","NORDESTE","CEARÁ","613.3170259",36822,15790,15785,5,"3.1"
2308500,"MOMBAÇA","NORDESTE","CEARÁ","2115.7477593",37735,19083,19079,4,"2.8"
2308609,"MONSENHOR TABOSA","NORDESTE","CEARÁ","892.5381584",17149,7830,7828,2,"2.9"
2308708,"MORADA NOVA","NORDESTE","CEARÁ","2763.9706099",61443,28744,28729,15,"2.7"
2308807,"MORAÚJO","NORDESTE","CEARÁ","414.4457781",8254,3642,3642,0,"3"
2308906,"MORRINHOS","NORDESTE","CEARÁ","411.5861638",22753,9368,9367,1,"3.1"
2309003,"MUCAMBO","NORDESTE","CEARÁ","192.1898819",13666,6622,6621,1,"2.7"
2309102,"MULUNGU","NORDESTE","CEARÁ","97.9505557",10569,4454,4454,0,"3.2"
2309201,"NOVA OLINDA","NORDESTE","CEARÁ","282.5843014",15399,6730,6726,4,"3"
2309300,"NOVA RUSSAS","NORDESTE","CEARÁ","736.9110653",30699,13668,13658,10,"2.8"
2309409,"NOVO ORIENTE","NORDESTE","CEARÁ","947.4403306",27545,12674,12669,5,"2.8"
2309458,"OCARA","NORDESTE","CEARÁ","763.0754505",24493,12128,12127,1,"2.8"
2309508,"ORÓS","NORDESTE","CEARÁ","577.5263031",19675,9105,9101,4,"2.7"
2309607,"PACAJUS","NORDESTE","CEARÁ","250.3039386",70983,30243,30237,6,"3"
2309706,"PACATUBA","NORDESTE","CEARÁ","133.223277",81524,32182,32165,17,"3"
2309805,"PACOTI","NORDESTE","CEARÁ","112.4334109",11186,4863,4846,17,"3"
2309904,"PACUJÁ","NORDESTE","CEARÁ","88.3552077",6175,2798,2795,3,"2.8"
2310001,"PALHANO","NORDESTE","CEARÁ","436.9800292",9346,4254,4252,2,"2.9"
2310100,"PALMÁCIA","NORDESTE","CEARÁ","128.8959914",10242,4287,4284,3,"3"
2310209,"PARACURU","NORDESTE","CEARÁ","304.7344068",38980,20215,20183,32,"3"
2310258,"PARAIPABA","NORDESTE","CEARÁ","289.230818",32216,14338,14303,35,"3"
2310308,"PARAMBU","NORDESTE","CEARÁ","2313.8683131",31445,15369,15365,4,"2.8"
2310407,"PARAMOTI","NORDESTE","CEARÁ","539.2380609",10384,5039,5038,1,"2.9"
2310506,"PEDRA BRANCA","NORDESTE","CEARÁ","1302.0811177",40187,18663,18652,11,"2.8"
2310605,"PENAFORTE","NORDESTE","CEARÁ","150.5355438",8972,3984,3978,6,"3.1"
2310704,"PENTECOSTE","NORDESTE","CEARÁ","1379.8360018",37813,16703,16695,8,"3"
2310803,"PEREIRO","NORDESTE","CEARÁ","435.8684138",15274,7362,7358,4,"2.9"
2310852,"PINDORETAMA","NORDESTE","CEARÁ","74.0330016",23391,10578,10575,3,"2.9"
2310902,"PIQUET CARNEIRO","NORDESTE","CEARÁ","589.6007521",16616,7203,7200,3,"2.9"
2310951,"PIRES FERREIRA","NORDESTE","CEARÁ","244.4641778",10606,3910,3909,1,"3.2"
2311009,"PORANGA","NORDESTE","CEARÁ","1310.7709203",12065,6065,6061,4,"2.9"
2311108,"PORTEIRAS","NORDESTE","CEARÁ","224.8603883",17050,7018,7018,0,"3.1"
2311207,"POTENGI","NORDESTE","CEARÁ","343.2643898",8833,4337,4336,1,"2.8"
2311231,"POTIRETAMA","NORDESTE","CEARÁ","409.1374439",5974,2813,2811,2,"2.8"
2311264,"QUITERIANÓPOLIS","NORDESTE","CEARÁ","1041.8322274",20213,9347,9341,6,"2.9"
2311306,"QUIXADÁ","NORDESTE","CEARÁ","2020.585735",84168,36341,36312,29,"2.9"
2311355,"QUIXELÔ","NORDESTE","CEARÁ","605.3453472",15910,7415,7414,1,"2.7"
2311405,"QUIXERAMOBIM","NORDESTE","CEARÁ","3324.986963",82177,34179,34171,8,"2.9"
2311504,"QUIXERÉ","NORDESTE","CEARÁ","613.0987857",20874,10078,10072,6,"2.7"
2311603,"REDENÇÃO","NORDESTE","CEARÁ","247.9888613",27214,12091,12084,7,"3"
2311702,"RERIUTABA","NORDESTE","CEARÁ","372.9486991",18606,8473,8471,2,"2.8"
2311801,"RUSSAS","NORDESTE","CEARÁ","1611.0909609",72928,34647,34624,23,"2.8"
2311900,"SABOEIRO","NORDESTE","CEARÁ","1381.2742875",13854,7009,7003,6,"2.8"
2311959,"SALITRE","NORDESTE","CEARÁ","806.2533306",16633,7092,7090,2,"3.1"
2312007,"SANTANA DO ACARAÚ","NORDESTE","CEARÁ","972.5734208",30628,11919,11912,7,"3.2"
2312106,"SANTANA DO CARIRI","NORDESTE","CEARÁ","855.1651043",16954,8011,8011,0,"3"
2312205,"SANTA QUITÉRIA","NORDESTE","CEARÁ","4262.2928833",40183,17527,17519,8,"2.9"
2312304,"SÃO BENEDITO","NORDESTE","CEARÁ","350.846713",47640,19459,19449,10,"3"
2312403,"SÃO GONÇALO DO AMARANTE","NORDESTE","CEARÁ","842.6354551",54143,27508,27218,290,"3"
2312502,"SÃO JOÃO DO JAGUARIBE","NORDESTE","CEARÁ","279.4512455",5855,3570,3568,2,"2.5"
2312601,"SÃO LUÍS DO CURU","NORDESTE","CEARÁ","122.8648943",10822,5280,5261,19,"2.8"
2312700,"SENADOR POMPEU","NORDESTE","CEARÁ","956.8821091",24266,11741,11733,8,"2.7"
2312809,"SENADOR SÁ","NORDESTE","CEARÁ","424.6417535",7262,3266,3264,2,"3"
2312908,"SOBRAL","NORDESTE","CEARÁ","2068.4741773",203023,84238,84156,82,"3"
2313005,"SOLONÓPOLE","NORDESTE","CEARÁ","1535.8549516",18179,8201,8199,2,"2.8"
2313104,"TABULEIRO DO NORTE","NORDESTE","CEARÁ","1047.6373556",30652,15326,15321,5,"2.6"
2313203,"TAMBORIL","NORDESTE","CEARÁ","2014.5433411",24815,10998,10989,9,"2.9"
2313252,"TARRAFAS","NORDESTE","CEARÁ","412.7185294",7529,3755,3754,1,"2.8"
2313302,"TAUÁ","NORDESTE","CEARÁ","4010.6183678",61227,27061,27047,14,"2.9"
2313351,"TEJUÇUOCA","NORDESTE","CEARÁ","758.7063635",17154,7683,7676,7,"3.1"
2313401,"TIANGUÁ","NORDESTE","CEARÁ","909.8525666",81506,32536,32511,25,"3.2"
2313500,"TRAIRI","NORDESTE","CEARÁ","928.7247154",58415,25960,25904,56,"3.1"
2313559,"TURURU","NORDESTE","CEARÁ","201.2698585",15412,7212,7210,2,"3"
2313609,"UBAJARA","NORDESTE","CEARÁ","423.6733501",32767,13424,13413,11,"3.1"
2313708,"UMARI","NORDESTE","CEARÁ","263.1825921",6871,3139,3138,1,"2.9"
2313757,"UMIRIM","NORDESTE","CEARÁ","315.647821",17470,7600,7580,20,"3.1"
2313807,"URUBURETAMA","NORDESTE","CEARÁ","99.4000255",20189,7969,7958,11,"3.2"
2313906,"URUOCA","NORDESTE","CEARÁ","697.683192",13746,5936,5932,4,"2.9"
2313955,"VARJOTA","NORDESTE","CEARÁ","179.2389781",18105,7488,7486,2,"3"
2314003,"VÁRZEA ALEGRE","NORDESTE","CEARÁ","829.9762111",38984,17842,17836,6,"2.8"
2314102,"VIÇOSA DO CEARÁ","NORDESTE","CEARÁ","1310.910074",59712,22760,22748,12,"3.3"
2400109,"ACARI","NORDESTE","RIO GRANDE DO NORTE","608.4660515",10597,4750,4747,3,"2.8"
2400208,"AÇU","NORDESTE","RIO GRANDE DO NORTE","1303.4416751",56496,24138,24103,35,"2.9"
2400307,"AFONSO BEZERRA","NORDESTE","RIO GRANDE DO NORTE","576.1790413",10839,4339,4334,5,"3.2"
2400406,"ÁGUA NOVA","NORDESTE","RIO GRANDE DO NORTE","50.6838928",2946,1199,1199,0,"3"
2400505,"ALEXANDRIA","NORDESTE","RIO GRANDE DO NORTE","381.2049921",13640,6043,6040,3,"2.8"
2400604,"ALMINO AFONSO","NORDESTE","RIO GRANDE DO NORTE","128.0376759",4687,2348,2346,2,"2.8"
2400703,"ALTO DO RODRIGUES","NORDESTE","RIO GRANDE DO NORTE","191.3337473",12484,5384,5368,16,"3"
2400802,"ANGICOS","NORDESTE","RIO GRANDE DO NORTE","741.5817031",11632,5195,5174,21,"2.9"
2400901,"ANTÔNIO MARTINS","NORDESTE","RIO GRANDE DO NORTE","244.8969293",6577,3181,3181,0,"2.8"
2401008,"APODI","NORDESTE","RIO GRANDE DO NORTE","1602.4765805",36093,16745,16732,13,"2.8"
2401107,"AREIA BRANCA","NORDESTE","RIO GRANDE DO NORTE","342.7491369",24093,11691,11680,11,"2.9"
2401206,"ARÊS","NORDESTE","RIO GRANDE DO NORTE","115.4068587",13251,5112,5111,1,"3.1"
2401305,"CAMPO GRANDE","NORDESTE","RIO GRANDE DO NORTE","890.8901122",9730,4168,4167,1,"3"
2401404,"BAÍA FORMOSA","NORDESTE","RIO GRANDE DO NORTE","247.4839836",8825,3812,3807,5,"3.2"
2401453,"BARAÚNA","NORDESTE","RIO GRANDE DO NORTE","825.68064",26913,11116,11112,4,"3"
2401503,"BARCELONA","NORDESTE","RIO GRANDE DO NORTE","152.6258974",3986,1858,1858,0,"2.9"
2401602,"BENTO FERNANDES","NORDESTE","RIO GRANDE DO NORTE","301.0687993",4807,1971,1970,1,"3.1"
2401651,"BODÓ","NORDESTE","RIO GRANDE DO NORTE","253.5186219",2306,1163,1163,0,"3"
2401701,"BOM JESUS","NORDESTE","RIO GRANDE DO NORTE","122.0348304",9952,4469,4468,1,"2.9"
2401800,"BREJINHO","NORDESTE","RIO GRANDE DO NORTE","61.5588015",12202,5232,5211,21,"2.9"
2401859,"CAIÇARA DO NORTE","NORDESTE","RIO GRANDE DO NORTE","225.6327203",6293,2594,2591,3,"3.2"
2401909,"CAIÇARA DO RIO DO VENTO","NORDESTE","RIO GRANDE DO NORTE","261.1938797",3268,1407,1406,1,"3.1"
2402006,"CAICÓ","NORDESTE","RIO GRANDE DO NORTE","1228.5834895",61146,27198,27128,70,"2.7"
2402105,"CAMPO REDONDO","NORDESTE","RIO GRANDE DO NORTE","213.7265242",10215,4608,4606,2,"2.9"
2402204,"CANGUARETAMA","NORDESTE","RIO GRANDE DO NORTE","245.4854435",29668,12592,12564,28,"3.2"
2402303,"CARAÚBAS","NORDESTE","RIO GRANDE DO NORTE","1095.802559",19727,9418,9404,14,"2.8"
2402402,"CARNAÚBA DOS DANTAS","NORDESTE","RIO GRANDE DO NORTE","246.3079925",7992,3592,3589,3,"2.8"
2402501,"CARNAUBAIS","NORDESTE","RIO GRANDE DO NORTE","517.7365545",9714,4176,4168,8,"3"
2402600,"CEARÁ-MIRIM","NORDESTE","RIO GRANDE DO NORTE","724.8376872",79115,34272,34246,26,"3.1"
2402709,"CERRO CORÁ","NORDESTE","RIO GRANDE DO NORTE","393.5729859",11000,5209,5204,5,"3"
2402808,"CORONEL EZEQUIEL","NORDESTE","RIO GRANDE DO NORTE","185.7480615",5117,2879,2878,1,"2.7"
2402907,"CORONEL JOÃO PESSOA","NORDESTE","RIO GRANDE DO NORTE","117.1390814",4237,1878,1878,0,"2.9"
2403004,"CRUZETA","NORDESTE","RIO GRANDE DO NORTE","295.8304416",8005,3639,3631,8,"2.7"
2403103,"CURRAIS NOVOS","NORDESTE","RIO GRANDE DO NORTE","864.3489606",41313,18201,18180,21,"2.8"
2403202,"DOUTOR SEVERIANO","NORDESTE","RIO GRANDE DO NORTE","113.7369092",7044,2870,2870,0,"2.9"
2403251,"PARNAMIRIM","NORDESTE","RIO GRANDE DO NORTE","124.0059226",252716,116679,116627,52,"2.8"
2403301,"ENCANTO","NORDESTE","RIO GRANDE DO NORTE","125.7488328",6016,2579,2578,1,"3"
2403400,"EQUADOR","NORDESTE","RIO GRANDE DO NORTE","264.9853849",5360,2762,2761,1,"2.7"
2403509,"ESPÍRITO SANTO","NORDESTE","RIO GRANDE DO NORTE","135.8374758",10620,4391,4390,1,"3"
2403608,"EXTREMOZ","NORDESTE","RIO GRANDE DO NORTE","140.6391",61635,32161,32143,18,"3"
2403707,"FELIPE GUERRA","NORDESTE","RIO GRANDE DO NORTE","268.591274",5944,2578,2576,2,"2.9"
2403756,"FERNANDO PEDROZA","NORDESTE","RIO GRANDE DO NORTE","322.6278585",2938,1333,1332,1,"2.8"
2403806,"FLORÂNIA","NORDESTE","RIO GRANDE DO NORTE","507.892395",10196,4263,4261,2,"3"
2403905,"FRANCISCO DANTAS","NORDESTE","RIO GRANDE DO NORTE","181.5583072",2700,1341,1341,0,"2.7"
2404002,"FRUTUOSO GOMES","NORDESTE","RIO GRANDE DO NORTE","63.2792782",4122,1977,1976,1,"2.7"
2404101,"GALINHOS","NORDESTE","RIO GRANDE DO NORTE","340.7691443",2104,866,851,15,"3.4"
2404200,"GOIANINHA","NORDESTE","RIO GRANDE DO NORTE","192.2794028",26741,9904,9898,6,"3.2"
2404309,"GOVERNADOR DIX-SEPT ROSADO","NORDESTE","RIO GRANDE DO NORTE","1129.5502685",11938,5661,5659,2,"2.9"
2404408,"GROSSOS","NORDESTE","RIO GRANDE DO NORTE","124.5377913",9924,4407,4402,5,"2.9"
2404507,"GUAMARÉ","NORDESTE","RIO GRANDE DO NORTE","258.307308",15295,6486,6468,18,"3.1"
2404606,"IELMO MARINHO","NORDESTE","RIO GRANDE DO NORTE","312.0284243",11615,4987,4987,0,"3"
2404705,"IPANGUAÇU","NORDESTE","RIO GRANDE DO NORTE","374.2453416",14131,5590,5586,4,"3.2"
2404804,"IPUEIRA","NORDESTE","RIO GRANDE DO NORTE","127.3476123",2035,997,996,1,"2.6"
2404853,"ITAJÁ","NORDESTE","RIO GRANDE DO NORTE","203.6240717",7292,3130,3127,3,"3"
2404903,"ITAÚ","NORDESTE","RIO GRANDE DO NORTE","133.0308323",5320,2431,2428,3,"2.8"
2405009,"JAÇANÃ","NORDESTE","RIO GRANDE DO NORTE","54.5609003",7834,3804,3803,1,"2.8"
2405108,"JANDAÍRA","NORDESTE","RIO GRANDE DO NORTE","442.7541054",6562,2764,2762,2,"3.1"
2405207,"JANDUÍS","NORDESTE","RIO GRANDE DO NORTE","303.4482115",4746,2040,2038,2,"3.1"
2405306,"JANUÁRIO CICCO","NORDESTE","RIO GRANDE DO NORTE","170.7367446",9051,4130,4130,0,"2.9"
2405405,"JAPI","NORDESTE","RIO GRANDE DO NORTE","188.9901368",5117,2823,2823,0,"2.9"
2405504,"JARDIM DE ANGICOS","NORDESTE","RIO GRANDE DO NORTE","254.0124124",2437,1051,1050,1,"3.1"
2405603,"JARDIM DE PIRANHAS","NORDESTE","RIO GRANDE DO NORTE","330.5304593",13977,6192,6188,4,"2.8"
2405702,"JARDIM DO SERIDÓ","NORDESTE","RIO GRANDE DO NORTE","367.644708",11655,5623,5619,4,"2.6"
2405801,"JOÃO CÂMARA","NORDESTE","RIO GRANDE DO NORTE","714.9705524",33290,14189,14170,19,"3.1"
2405900,"JOÃO DIAS","NORDESTE","RIO GRANDE DO NORTE","88.1727597",2076,1029,1029,0,"2.7"
2406007,"JOSÉ DA PENHA","NORDESTE","RIO GRANDE DO NORTE","117.6346337",5803,2784,2784,0,"2.7"
2406106,"JUCURUTU","NORDESTE","RIO GRANDE DO NORTE","933.7300873",17793,8540,8535,5,"2.8"
2406155,"JUNDIÁ","NORDESTE","RIO GRANDE DO NORTE","44.6409531",3739,1619,1618,1,"3"
2406205,"LAGOA D'ANTA","NORDESTE","RIO GRANDE DO NORTE","105.6520621",6654,3023,3020,3,"3"
2406304,"LAGOA DE PEDRAS","NORDESTE","RIO GRANDE DO NORTE","117.9714206",7338,3405,3405,0,"2.8"
2406403,"LAGOA DE VELHOS","NORDESTE","RIO GRANDE DO NORTE","111.6068126",2567,1225,1224,1,"2.9"
2406502,"LAGOA NOVA","NORDESTE","RIO GRANDE DO NORTE","176.3016107",15573,7193,7187,6,"3"
2406601,"LAGOA SALGADA","NORDESTE","RIO GRANDE DO NORTE","79.127602",8319,3568,3567,1,"2.9"
2406700,"LAJES","NORDESTE","RIO GRANDE DO NORTE","676.625513",9866,4364,4361,3,"3.1"
2406809,"LAJES PINTADAS","NORDESTE","RIO GRANDE DO NORTE","130.2111795",4787,2476,2476,0,"2.8"
2406908,"LUCRÉCIA","NORDESTE","RIO GRANDE DO NORTE","30.9309649",3490,1496,1495,1,"2.9"
2407005,"LUÍS GOMES","NORDESTE","RIO GRANDE DO NORTE","166.6378487",9070,3959,3958,1,"3"
2407104,"MACAÍBA","NORDESTE","RIO GRANDE DO NORTE","510.0918527",82249,38169,38152,17,"2.9"
2407203,"MACAU","NORDESTE","RIO GRANDE DO NORTE","775.3021841",27369,12928,12915,13,"2.8"
2407252,"MAJOR SALES","NORDESTE","RIO GRANDE DO NORTE","31.9709428",3924,1576,1576,0,"2.9"
2407302,"MARCELINO VIEIRA","NORDESTE","RIO GRANDE DO NORTE","345.710981",7896,3553,3552,1,"2.9"
2407401,"MARTINS","NORDESTE","RIO GRANDE DO NORTE","169.463775",8179,3991,3989,2,"2.8"
2407500,"MAXARANGUAPE","NORDESTE","RIO GRANDE DO NORTE","132.1289308",10255,5576,5564,12,"3.2"
2407609,"MESSIAS TARGINO","NORDESTE","RIO GRANDE DO NORTE","142.6076882",4274,1861,1861,0,"3"
2407708,"MONTANHAS","NORDESTE","RIO GRANDE DO NORTE","82.2136583",11444,4644,4643,1,"3"
2407807,"MONTE ALEGRE","NORDESTE","RIO GRANDE DO NORTE","211.2591714",23031,10024,10022,2,"3"
2407906,"MONTE DAS GAMELEIRAS","NORDESTE","RIO GRANDE DO NORTE","71.9460968",2276,1245,1244,1,"2.9"
2408003,"MOSSORÓ","NORDESTE","RIO GRANDE DO NORTE","2099.3343287",264577,123480,123412,68,"2.8"
2408102,"NATAL","NORDESTE","RIO GRANDE DO NORTE","167.4013241",751300,337029,336655,374,"2.8"
2408201,"NÍSIA FLORESTA","NORDESTE","RIO GRANDE DO NORTE","307.7189503",31942,20175,20153,22,"3"
2408300,"NOVA CRUZ","NORDESTE","RIO GRANDE DO NORTE","277.6583928",34269,14199,14178,21,"3"
2408409,"OLHO D'ÁGUA DO BORGES","NORDESTE","RIO GRANDE DO NORTE","141.1702134",3905,1903,1902,1,"2.8"
2408508,"OURO BRANCO","NORDESTE","RIO GRANDE DO NORTE","253.2102776",4913,2349,2347,2,"2.8"
2408607,"PARANÁ","NORDESTE","RIO GRANDE DO NORTE","81.3904636",3934,1611,1611,0,"3"
2408706,"PARAÚ","NORDESTE","RIO GRANDE DO NORTE","383.2143935",3579,1722,1720,2,"2.9"
2408805,"PARAZINHO","NORDESTE","RIO GRANDE DO NORTE","231.0065851",4801,2038,2038,0,"3.2"
2408904,"PARELHAS","NORDESTE","RIO GRANDE DO NORTE","513.506507",21499,10396,10382,14,"2.8"
2408953,"RIO DO FOGO","NORDESTE","RIO GRANDE DO NORTE","151.0969791",10351,5571,5567,4,"3.3"
2409100,"PASSA E FICA","NORDESTE","RIO GRANDE DO NORTE","42.1365958",10896,4724,4712,12,"2.9"
2409209,"PASSAGEM","NORDESTE","RIO GRANDE DO NORTE","41.2148946",3115,1401,1401,0,"2.9"
2409308,"PATU","NORDESTE","RIO GRANDE DO NORTE","319.1348335",11007,5246,5238,8,"2.7"
2409332,"SANTA MARIA","NORDESTE","RIO GRANDE DO NORTE","219.5703064",4847,2208,2205,3,"3"
2409407,"PAU DOS FERROS","NORDESTE","RIO GRANDE DO NORTE","259.9592341",30479,13051,13041,10,"2.8"
2409506,"PEDRA GRANDE","NORDESTE","RIO GRANDE DO NORTE","221.1669971",3618,1783,1781,2,"3.3"
2409605,"PEDRA PRETA","NORDESTE","RIO GRANDE DO NORTE","294.9848764",2441,1084,1083,1,"3.1"
2409704,"PEDRO AVELINO","NORDESTE","RIO GRANDE DO NORTE","952.7551577",6242,2981,2975,6,"3"
2409803,"PEDRO VELHO","NORDESTE","RIO GRANDE DO NORTE","192.7083825",13824,5752,5751,1,"3.1"
2409902,"PENDÊNCIAS","NORDESTE","RIO GRANDE DO NORTE","419.1367959",12278,5269,5234,35,"2.9"
2410009,"PILÕES","NORDESTE","RIO GRANDE DO NORTE","82.6900567",2965,1353,1352,1,"2.8"
2410108,"POÇO BRANCO","NORDESTE","RIO GRANDE DO NORTE","230.4008999",12390,4757,4753,4,"3.2"
2410207,"PORTALEGRE","NORDESTE","RIO GRANDE DO NORTE","110.0536496",7601,3448,3443,5,"2.8"
2410256,"PORTO DO MANGUE","NORDESTE","RIO GRANDE DO NORTE","361.2366357",5228,2492,2489,3,"3"
2410306,"SERRA CAIADA","NORDESTE","RIO GRANDE DO NORTE","217.5388048",10125,3930,3926,4,"3.1"
2410405,"PUREZA","NORDESTE","RIO GRANDE DO NORTE","504.2937851",9362,4004,4000,4,"3.1"
2410504,"RAFAEL FERNANDES","NORDESTE","RIO GRANDE DO NORTE","78.2308706",5432,2301,2300,1,"2.9"
2410603,"RAFAEL GODEIRO","NORDESTE","RIO GRANDE DO NORTE","100.0729478",2934,1484,1483,1,"2.7"
2410702,"RIACHO DA CRUZ","NORDESTE","RIO GRANDE DO NORTE","127.2229133",2701,1237,1237,0,"2.9"
2410801,"RIACHO DE SANTANA","NORDESTE","RIO GRANDE DO NORTE","128.1057559",4127,1824,1824,0,"2.9"
2410900,"RIACHUELO","NORDESTE","RIO GRANDE DO NORTE","262.8874511",7389,3011,3010,1,"3.1"
2411007,"RODOLFO FERNANDES","NORDESTE","RIO GRANDE DO NORTE","154.8398312",4242,1890,1888,2,"2.8"
2411056,"TIBAU","NORDESTE","RIO GRANDE DO NORTE","169.3652572",5382,5700,5680,20,"2.9"
2411106,"RUY BARBOSA","NORDESTE","RIO GRANDE DO NORTE","125.8085231",3206,1613,1613,0,"2.9"
2411205,"SANTA CRUZ","NORDESTE","RIO GRANDE DO NORTE","624.3557746",37313,17091,17061,30,"2.9"
2411403,"SANTANA DO MATOS","NORDESTE","RIO GRANDE DO NORTE","1422.2683799",12456,6278,6276,2,"2.8"
2411429,"SANTANA DO SERIDÓ","NORDESTE","RIO GRANDE DO NORTE","188.40314",2696,1334,1334,0,"2.9"
2411502,"SANTO ANTÔNIO","NORDESTE","RIO GRANDE DO NORTE","301.0815366",22177,9693,9687,6,"2.9"
2411601,"SÃO BENTO DO NORTE","NORDESTE","RIO GRANDE DO NORTE","288.7614145",3304,1398,1395,3,"3.1"
2411700,"SÃO BENTO DO TRAIRÍ","NORDESTE","RIO GRANDE DO NORTE","190.8177542",3792,1882,1882,0,"2.9"
2411809,"SÃO FERNANDO","NORDESTE","RIO GRANDE DO NORTE","404.4273869",3492,1621,1621,0,"2.8"
2411908,"SÃO FRANCISCO DO OESTE","NORDESTE","RIO GRANDE DO NORTE","75.5877196",4161,1868,1868,0,"2.8"
2412005,"SÃO GONÇALO DO AMARANTE","NORDESTE","RIO GRANDE DO NORTE","249.799578",115838,54203,54189,14,"2.9"
2412104,"SÃO JOÃO DO SABUGI","NORDESTE","RIO GRANDE DO NORTE","277.0114132",5956,2889,2888,1,"2.6"
2412203,"SÃO JOSÉ DE MIPIBU","NORDESTE","RIO GRANDE DO NORTE","289.9874239",47286,20814,20802,12,"3"
2412302,"SÃO JOSÉ DO CAMPESTRE","NORDESTE","RIO GRANDE DO NORTE","341.1153909",11121,5011,5007,4,"3"
2412401,"SÃO JOSÉ DO SERIDÓ","NORDESTE","RIO GRANDE DO NORTE","174.5051441",4558,1846,1845,1,"2.9"
2412500,"SÃO MIGUEL","NORDESTE","RIO GRANDE DO NORTE","166.2327274",23537,10623,10612,11,"2.8"
2412559,"SÃO MIGUEL DO GOSTOSO","NORDESTE","RIO GRANDE DO NORTE","431.4445123",10221,4789,4738,51,"3.2"
2412609,"SÃO PAULO DO POTENGI","NORDESTE","RIO GRANDE DO NORTE","240.4252608",16786,7596,7592,4,"2.9"
2412708,"SÃO PEDRO","NORDESTE","RIO GRANDE DO NORTE","195.2373176",5776,2787,2787,0,"3"
2412807,"SÃO RAFAEL","NORDESTE","RIO GRANDE DO NORTE","469.1013989",7711,3634,3631,3,"2.8"
2412906,"SÃO TOMÉ","NORDESTE","RIO GRANDE DO NORTE","862.584684",9972,4895,4894,1,"2.8"
2413003,"SÃO VICENTE","NORDESTE","RIO GRANDE DO NORTE","197.817142",6310,3039,3037,2,"2.8"
2413102,"SENADOR ELÓI DE SOUZA","NORDESTE","RIO GRANDE DO NORTE","152.3759353",5965,2730,2730,0,"2.9"
2413201,"SENADOR GEORGINO AVELINO","NORDESTE","RIO GRANDE DO NORTE","26.1004822",4065,1525,1525,0,"3.2"
2413300,"SERRA DE SÃO BENTO","NORDESTE","RIO GRANDE DO NORTE","96.6275333",5703,2787,2765,22,"2.9"
2413359,"SERRA DO MEL","NORDESTE","RIO GRANDE DO NORTE","620.2409577",13091,5757,5752,5,"3.1"
2413409,"SERRA NEGRA DO NORTE","NORDESTE","RIO GRANDE DO NORTE","562.3961823",7597,3098,3092,6,"2.9"
2413508,"SERRINHA","NORDESTE","RIO GRANDE DO NORTE","193.3510167",6436,3098,3098,0,"2.9"
2413557,"SERRINHA DOS PINTOS","NORDESTE","RIO GRANDE DO NORTE","122.374994",4659,2168,2168,0,"2.8"
2413607,"SEVERIANO MELO","NORDESTE","RIO GRANDE DO NORTE","157.85029",5487,2603,2601,2,"2.8"
2413706,"SÍTIO NOVO","NORDESTE","RIO GRANDE DO NORTE","213.45622",4654,2340,2340,0,"2.8"
2413805,"TABOLEIRO GRANDE","NORDESTE","RIO GRANDE DO NORTE","124.0933205",2338,1062,1061,1,"2.8"
2413904,"TAIPU","NORDESTE","RIO GRANDE DO NORTE","352.8183727",11422,4986,4984,2,"3.1"
2414001,"TANGARÁ","NORDESTE","RIO GRANDE DO NORTE","339.4836935",13281,6115,6110,5,"3"
2414100,"TENENTE ANANIAS","NORDESTE","RIO GRANDE DO NORTE","223.6714286",10262,4119,4117,2,"3"
2414159,"TENENTE LAURENTINO CRUZ","NORDESTE","RIO GRANDE DO NORTE","68.5557556",5891,2523,2520,3,"3"
2414209,"TIBAU DO SUL","NORDESTE","RIO GRANDE DO NORTE","102.6799116",16929,8966,8834,132,"2.8"
2414308,"TIMBAÚBA DOS BATISTAS","NORDESTE","RIO GRANDE DO NORTE","135.4556067",2348,1029,1027,2,"2.8"
2414407,"TOUROS","NORDESTE","RIO GRANDE DO NORTE","753.9606269",33035,14455,14438,17,"3.2"
2414456,"TRIUNFO POTIGUAR","NORDESTE","RIO GRANDE DO NORTE","268.7251414",3376,1500,1493,7,"3"
2414506,"UMARIZAL","NORDESTE","RIO GRANDE DO NORTE","213.5835618",10078,4667,4663,4,"2.7"
2414605,"UPANEMA","NORDESTE","RIO GRANDE DO NORTE","873.1397859",13577,6102,6100,2,"2.9"
2414704,"VÁRZEA","NORDESTE","RIO GRANDE DO NORTE","72.6841298",5233,2238,2235,3,"2.9"
2414753,"VENHA-VER","NORDESTE","RIO GRANDE DO NORTE","71.6211645",3014,1384,1384,0,"3"
2414803,"VERA CRUZ","NORDESTE","RIO GRANDE DO NORTE","84.1270753",10735,4507,4506,1,"3"
2414902,"VIÇOSA","NORDESTE","RIO GRANDE DO NORTE","37.9045551",1822,788,788,0,"2.9"
2415008,"VILA FLOR","NORDESTE","RIO GRANDE DO NORTE","47.6563842",3174,1177,1176,1,"3.2"
2500106,"ÁGUA BRANCA","NORDESTE","PARAÍBA","241.6619206",9335,4434,4434,0,"2.9"
2500205,"AGUIAR","NORDESTE","PARAÍBA","351.6069246",5003,2730,2729,1,"2.7"
2500304,"ALAGOA GRANDE","NORDESTE","PARAÍBA","322.0708897",26062,11783,11780,3,"3"
2500403,"ALAGOA NOVA","NORDESTE","PARAÍBA","128.2301786",21013,8685,8682,3,"3"
2500502,"ALAGOINHA","NORDESTE","PARAÍBA","111.3611147",13725,5525,5522,3,"3.1"
2500536,"ALCANTIL","NORDESTE","PARAÍBA","309.8959596",5578,2871,2871,0,"2.8"
2500577,"ALGODÃO DE JANDAÍRA","NORDESTE","PARAÍBA","222.7396525",2953,1398,1397,1,"3"
2500601,"ALHANDRA","NORDESTE","PARAÍBA","183.9737843",21730,9151,9140,11,"3"
2500700,"SÃO JOÃO DO RIO DO PEIXE","NORDESTE","PARAÍBA","476.2374885",17964,8523,8518,5,"2.8"
2500734,"AMPARO","NORDESTE","PARAÍBA","122.093879",2234,1194,1194,0,"2.8"
2500775,"APARECIDA","NORDESTE","PARAÍBA","291.477612",7960,3424,3424,0,"3"
2500809,"ARAÇAGI","NORDESTE","PARAÍBA","232.1770768",16646,7404,7404,0,"2.9"
2500908,"ARARA","NORDESTE","PARAÍBA","91.3057712",12212,6002,6001,1,"2.8"
2501005,"ARARUNA","NORDESTE","PARAÍBA","246.7169711",17189,8625,8621,4,"3"
2501104,"AREIA","NORDESTE","PARAÍBA","269.1295731",22633,10203,10191,12,"3.1"
2501153,"AREIA DE BARAÚNAS","NORDESTE","PARAÍBA","114.0782507",2005,932,932,0,"3"
2501203,"AREIAL","NORDESTE","PARAÍBA","35.8100653",7128,3244,3244,0,"2.9"
2501302,"AROEIRAS","NORDESTE","PARAÍBA","376.1179194",18705,9231,9227,4,"2.8"
2501351,"ASSUNÇÃO","NORDESTE","PARAÍBA","132.1394034",4152,1950,1948,2,"3"
2501401,"BAÍA DA TRAIÇÃO","NORDESTE","PARAÍBA","102.7560645",9224,5411,5400,11,"3.3"
2501500,"BANANEIRAS","NORDESTE","PARAÍBA","255.6406597",23134,10680,10667,13,"3.1"
2501534,"BARAÚNA","NORDESTE","PARAÍBA","50.0295924",4762,2400,2399,1,"2.8"
2501575,"BARRA DE SANTANA","NORDESTE","PARAÍBA","375.1765163",8059,4323,4322,1,"2.7"
2501609,"BARRA DE SANTA ROSA","NORDESTE","PARAÍBA","781.1874508",12904,6918,6916,2,"2.7"
2501708,"BARRA DE SÃO MIGUEL","NORDESTE","PARAÍBA","609.6968014",5906,3195,3192,3,"2.8"
2501807,"BAYEUX","NORDESTE","PARAÍBA","27.7045501",82742,32953,32942,11,"2.9"
2501906,"BELÉM","NORDESTE","PARAÍBA","99.6088133",16401,7291,7283,8,"2.8"
2502003,"BELÉM DO BREJO DO CRUZ","NORDESTE","PARAÍBA","601.5491955",6268,2823,2823,0,"3"
2502052,"BERNARDINO BATISTA","NORDESTE","PARAÍBA","57.4525729",3504,1405,1404,1,"3.1"
2502102,"BOA VENTURA","NORDESTE","PARAÍBA","168.6640362",5207,2375,2375,0,"3"
2502151,"BOA VISTA","NORDESTE","PARAÍBA","468.9334117",6377,2768,2766,2,"3"
2502201,"BOM JESUS","NORDESTE","PARAÍBA","47.367007",2286,1065,1065,0,"2.8"
2502300,"BOM SUCESSO","NORDESTE","PARAÍBA","186.0588658",4661,2517,2516,1,"2.7"
2502409,"BONITO DE SANTA FÉ","NORDESTE","PARAÍBA","226.7975776",10252,4614,4612,2,"3.1"
2502508,"BOQUEIRÃO","NORDESTE","PARAÍBA","373.0767849",17598,7561,7555,6,"2.9"
2502607,"IGARACY","NORDESTE","PARAÍBA","197.0575635",5648,2908,2907,1,"2.8"
2502706,"BORBOREMA","NORDESTE","PARAÍBA","26.1073982",4214,1948,1946,2,"3"
2502805,"BREJO DO CRUZ","NORDESTE","PARAÍBA","401.3148437",13613,5811,5805,6,"2.9"
2502904,"BREJO DOS SANTOS","NORDESTE","PARAÍBA","93.8571228",5742,2534,2534,0,"2.9"
2503001,"CAAPORÃ","NORDESTE","PARAÍBA","151.0177992",21193,8329,8329,0,"3.1"
2503100,"CABACEIRAS","NORDESTE","PARAÍBA","469.1706649",5335,2567,2564,3,"2.8"
2503209,"CABEDELO","NORDESTE","PARAÍBA","29.8728808",66519,33796,33778,18,"2.9"
2503308,"CACHOEIRA DOS ÍNDIOS","NORDESTE","PARAÍBA","193.2150393",9151,4151,4151,0,"2.9"
2503407,"CACIMBA DE AREIA","NORDESTE","PARAÍBA","213.0185023",3291,1923,1923,0,"2.9"
2503506,"CACIMBA DE DENTRO","NORDESTE","PARAÍBA","165.0724118",16064,7703,7701,2,"3"
2503555,"CACIMBAS","NORDESTE","PARAÍBA","124.0677177",7223,3299,3299,0,"3.2"
2503605,"CAIÇARA","NORDESTE","PARAÍBA","123.6769489",6602,2926,2912,14,"2.9"
2503704,"CAJAZEIRAS","NORDESTE","PARAÍBA","562.7030679",63239,29792,29774,18,"2.8"
2503753,"CAJAZEIRINHAS","NORDESTE","PARAÍBA","282.6932633",2740,1321,1320,1,"3.1"
2503803,"CALDAS BRANDÃO","NORDESTE","PARAÍBA","55.9633447",5753,2587,2587,0,"2.9"
2503902,"CAMALAÚ","NORDESTE","PARAÍBA","541.8406621",6085,3610,3610,0,"2.5"
2504009,"CAMPINA GRANDE","NORDESTE","PARAÍBA","591.6581571",419379,183901,183799,102,"2.8"
2504033,"CAPIM","NORDESTE","PARAÍBA","79.8755784",6970,2733,2733,0,"3.2"
2504074,"CARAÚBAS","NORDESTE","PARAÍBA","486.6216266",3944,2305,2304,1,"2.7"
2504108,"CARRAPATEIRA","NORDESTE","PARAÍBA","59.0701267",2312,900,899,1,"3.1"
2504157,"CASSERENGUE","NORDESTE","PARAÍBA","202.7608332",6889,3481,3479,2,"2.9"
2504207,"CATINGUEIRA","NORDESTE","PARAÍBA","527.4236491",4491,2095,2095,0,"3.1"
2504306,"CATOLÉ DO ROCHA","NORDESTE","PARAÍBA","551.7646732",30661,13154,13143,11,"2.9"
2504355,"CATURITÉ","NORDESTE","PARAÍBA","117.8233278",5254,2369,2369,0,"2.9"
2504405,"CONCEIÇÃO","NORDESTE","PARAÍBA","580.6499002",18260,8602,8596,6,"2.9"
2504504,"CONDADO","NORDESTE","PARAÍBA","265.4730456",6451,3062,3060,2,"2.8"
2504603,"CONDE","NORDESTE","PARAÍBA","171.2667676",27605,17952,17887,65,"3.1"
2504702,"CONGO","NORDESTE","PARAÍBA","324.6859926",4933,2816,2814,2,"2.6"
2504801,"COREMAS","NORDESTE","PARAÍBA","372.0124513",14683,6816,6812,4,"2.9"
2504850,"COXIXOLA","NORDESTE","PARAÍBA","173.9423668",1824,1006,1005,1,"2.5"
2504900,"CRUZ DO ESPÍRITO SANTO","NORDESTE","PARAÍBA","192.5122558",17095,6339,6338,1,"3.2"
2505006,"CUBATI","NORDESTE","PARAÍBA","163.5702698",7580,3523,3521,2,"2.9"
2505105,"CUITÉ","NORDESTE","PARAÍBA","733.8178154",19719,10717,10697,20,"2.8"
2505204,"CUITEGI","NORDESTE","PARAÍBA","42.0907552",6730,2787,2787,0,"3.1"
2505238,"CUITÉ DE MAMANGUAPE","NORDESTE","PARAÍBA","107.6801717",6251,2695,2695,0,"3"
2505279,"CURRAL DE CIMA","NORDESTE","PARAÍBA","86.4280764",5254,2282,2282,0,"3"
2505303,"CURRAL VELHO","NORDESTE","PARAÍBA","217.6235178",2292,978,978,0,"3.1"
2505352,"DAMIÃO","NORDESTE","PARAÍBA","186.1975825",4982,2603,2602,1,"2.8"
2505402,"DESTERRO","NORDESTE","PARAÍBA","182.0178098",8067,4088,4086,2,"2.8"
2505501,"VISTA SERRANA","NORDESTE","PARAÍBA","60.3895357",3641,1499,1499,0,"3"
2505600,"DIAMANTE","NORDESTE","PARAÍBA","271.7911241",6299,3006,3004,2,"3"
2505709,"DONA INÊS","NORDESTE","PARAÍBA","173.6479094",10380,4873,4871,2,"2.9"
2505808,"DUAS ESTRADAS","NORDESTE","PARAÍBA","27.0117971",3327,1563,1560,3,"2.8"
2505907,"EMAS","NORDESTE","PARAÍBA","248.2259493",3011,1356,1356,0,"3.1"
2506004,"ESPERANÇA","NORDESTE","PARAÍBA","157.8513992",31231,13964,13957,7,"2.9"
2506103,"FAGUNDES","NORDESTE","PARAÍBA","185.0611926",11049,5358,5356,2,"2.9"
2506202,"FREI MARTINHO","NORDESTE","PARAÍBA","238.6583642",2846,1554,1553,1,"2.6"
2506251,"GADO BRAVO","NORDESTE","PARAÍBA","192.420433",8179,3892,3892,0,"3"
2506301,"GUARABIRA","NORDESTE","PARAÍBA","162.3870546",57484,24270,24237,33,"2.9"
2506400,"GURINHÉM","NORDESTE","PARAÍBA","340.4078472",13766,5809,5808,1,"3"
2506509,"GURJÃO","NORDESTE","PARAÍBA","344.5020665",3242,1570,1570,0,"2.8"
2506608,"IBIARA","NORDESTE","PARAÍBA","240.3565832",5631,2804,2804,0,"2.8"
2506707,"IMACULADA","NORDESTE","PARAÍBA","317.8043294",10392,4599,4598,1,"3"
2506806,"INGÁ","NORDESTE","PARAÍBA","262.1787482",17692,8068,8062,6,"2.9"
2506905,"ITABAIANA","NORDESTE","PARAÍBA","210.5716979",23182,10685,10674,11,"2.8"
2507002,"ITAPORANGA","NORDESTE","PARAÍBA","460.210411",23940,10854,10841,13,"2.9"
2507101,"ITAPOROROCA","NORDESTE","PARAÍBA","145.8065392",18382,7421,7420,1,"3"
2507200,"ITATUBA","NORDESTE","PARAÍBA","251.7491935",10499,4450,4447,3,"3"
2507309,"JACARAÚ","NORDESTE","PARAÍBA","256.8447569",14477,6534,6529,5,"2.9"
2507408,"JERICÓ","NORDESTE","PARAÍBA","177.3558425",7516,3197,3197,0,"3"
2507507,"JOÃO PESSOA","NORDESTE","PARAÍBA","210.0444714",833932,377756,377504,252,"2.8"
2507606,"JUAREZ TÁVORA","NORDESTE","PARAÍBA","75.6781394",7796,3469,3468,1,"2.8"
2507705,"JUAZEIRINHO","NORDESTE","PARAÍBA","474.6064064",17007,7529,7528,1,"3.1"
2507804,"JUNCO DO SERIDÓ","NORDESTE","PARAÍBA","180.4248022",6793,3100,3096,4,"2.9"
2507903,"JURIPIRANGA","NORDESTE","PARAÍBA","78.7058503",10012,4000,3999,1,"3"
2508000,"JURU","NORDESTE","PARAÍBA","395.0748721",9234,4515,4515,0,"2.9"
2508109,"LAGOA","NORDESTE","PARAÍBA","176.6491378",4415,2068,2068,0,"2.9"
2508208,"LAGOA DE DENTRO","NORDESTE","PARAÍBA","83.5076798",7819,3657,3656,1,"3"
2508307,"LAGOA SECA","NORDESTE","PARAÍBA","108.2187879",27730,11758,11751,7,"3"
2508406,"LASTRO","NORDESTE","PARAÍBA","107.4159079",3162,1250,1250,0,"3.2"
2508505,"LIVRAMENTO","NORDESTE","PARAÍBA","266.9483739",6877,3453,3452,1,"2.8"
2508554,"LOGRADOURO","NORDESTE","PARAÍBA","42.8762393",4797,2003,2003,0,"3.1"
2508604,"LUCENA","NORDESTE","PARAÍBA","93.8001346",12560,9298,9292,6,"3.2"
2508703,"MÃE D'ÁGUA","NORDESTE","PARAÍBA","228.676454",3583,1987,1986,1,"2.7"
2508802,"MALTA","NORDESTE","PARAÍBA","172.0099301",6046,2583,2582,1,"2.9"
2508901,"MAMANGUAPE","NORDESTE","PARAÍBA","337.4337489",44599,17368,17358,10,"3.1"
2509008,"MANAÍRA","NORDESTE","PARAÍBA","352.0254278",10434,5286,5286,0,"2.9"
2509057,"MARCAÇÃO","NORDESTE","PARAÍBA","122.6654113",8999,3738,3738,0,"3.3"
2509107,"MARI","NORDESTE","PARAÍBA","155.2648132",21512,9111,9102,9,"2.9"
2509156,"MARIZÓPOLIS","NORDESTE","PARAÍBA","69.9518207",6705,2760,2760,0,"3"
2509206,"MASSARANDUBA","NORDESTE","PARAÍBA","209.4020744",14139,6548,6548,0,"2.9"
2509305,"MATARACA","NORDESTE","PARAÍBA","182.4387115",8244,3384,3381,3,"3.1"
2509339,"MATINHAS","NORDESTE","PARAÍBA","36.5220257",4571,1983,1983,0,"3.1"
2509370,"MATO GROSSO","NORDESTE","PARAÍBA","85.2746097",2543,1100,1100,0,"3.1"
2509396,"MATURÉIA","NORDESTE","PARAÍBA","83.053203",6433,3235,3232,3,"2.8"
2509404,"MOGEIRO","NORDESTE","PARAÍBA","214.0933876",13899,6484,6483,1,"2.9"
2509503,"MONTADAS","NORDESTE","PARAÍBA","31.7930278",5812,2433,2433,0,"3"
2509602,"MONTE HOREBE","NORDESTE","PARAÍBA","116.8538589",4338,2254,2250,4,"2.7"
2509701,"MONTEIRO","NORDESTE","PARAÍBA","992.6197952",32277,17629,17609,20,"2.6"
2509800,"MULUNGU","NORDESTE","PARAÍBA","187.2589628",8791,4173,4173,0,"2.9"
2509909,"NATUBA","NORDESTE","PARAÍBA","202.1726022",8945,4178,4175,3,"2.9"
2510006,"NAZAREZINHO","NORDESTE","PARAÍBA","193.2025581",7203,3299,3299,0,"2.9"
2510105,"NOVA FLORESTA","NORDESTE","PARAÍBA","47.5724336",9724,4784,4780,4,"2.7"
2510204,"NOVA OLINDA","NORDESTE","PARAÍBA","81.5163924",5787,2848,2848,0,"2.9"
2510303,"NOVA PALMEIRA","NORDESTE","PARAÍBA","314.7481504",4259,2203,2199,4,"2.8"
2510402,"OLHO D'ÁGUA","NORDESTE","PARAÍBA","580.4697316",6060,3007,3007,0,"3"
2510501,"OLIVEDOS","NORDESTE","PARAÍBA","314.6252133",3580,1833,1833,0,"2.8"
2510600,"OURO VELHO","NORDESTE","PARAÍBA","128.1103681",2918,1545,1545,0,"2.6"
2510659,"PARARI","NORDESTE","PARAÍBA","207.8143185",1720,958,957,1,"2.7"
2510709,"PASSAGEM","NORDESTE","PARAÍBA","123.422191",2463,1190,1190,0,"2.9"
2510808,"PATOS","NORDESTE","PARAÍBA","472.8921583",103165,45320,45277,43,"2.8"
2510907,"PAULISTA","NORDESTE","PARAÍBA","577.3792369",11834,5261,5260,1,"2.9"
2511004,"PEDRA BRANCA","NORDESTE","PARAÍBA","116.8732184",3739,1666,1666,0,"2.9"
2511103,"PEDRA LAVRADA","NORDESTE","PARAÍBA","335.6150919",6859,3278,3277,1,"2.8"
2511202,"PEDRAS DE FOGO","NORDESTE","PARAÍBA","406.7293322",29662,12230,12221,9,"3"
2511301,"PIANCÓ","NORDESTE","PARAÍBA","576.9863313",16441,7210,7204,6,"2.9"
2511400,"PICUÍ","NORDESTE","PARAÍBA","667.7138476",18333,9722,9715,7,"2.8"
2511509,"PILAR","NORDESTE","PARAÍBA","103.305836",12311,5211,5209,2,"2.9"
2511608,"PILÕES","NORDESTE","PARAÍBA","65.5740661",6815,2672,2671,1,"3.3"
2511707,"PILÕEZINHOS","NORDESTE","PARAÍBA","40.90804",5329,2214,2214,0,"3.1"
2511806,"PIRPIRITUBA","NORDESTE","PARAÍBA","80.6719679",9340,3991,3989,2,"3"
2511905,"PITIMBU","NORDESTE","PARAÍBA","135.8008109",16751,12830,12820,10,"3.1"
2512002,"POCINHOS","NORDESTE","PARAÍBA","623.9673455",17469,7851,7850,1,"3"
2512036,"POÇO DANTAS","NORDESTE","PARAÍBA","97.7577986",3830,1686,1686,0,"3"
2512077,"POÇO DE JOSÉ DE MOURA","NORDESTE","PARAÍBA","94.6464007",4006,1923,1922,1,"2.8"
2512101,"POMBAL","NORDESTE","PARAÍBA","894.0984733",32473,15181,15171,10,"2.9"
2512200,"PRATA","NORDESTE","PARAÍBA","201.7876577",3915,1895,1894,1,"2.7"
2512309,"PRINCESA ISABEL","NORDESTE","PARAÍBA","368.5693719",21114,9925,9915,10,"2.9"
2512408,"PUXINANÃ","NORDESTE","PARAÍBA","71.1178934",14277,6175,6174,1,"3"
2512507,"QUEIMADAS","NORDESTE","PARAÍBA","402.7480163",47658,21389,21384,5,"2.9"
2512606,"QUIXABA","NORDESTE","PARAÍBA","147.1582311",1743,916,916,0,"3"
2512705,"REMÍGIO","NORDESTE","PARAÍBA","183.4593711",17885,7930,7920,10,"3"
2512721,"PEDRO RÉGIS","NORDESTE","PARAÍBA","74.2164337",5766,2689,2689,0,"3"
2512747,"RIACHÃO","NORDESTE","PARAÍBA","85.2913915",2927,1387,1387,0,"2.9"
2512754,"RIACHÃO DO BACAMARTE","NORDESTE","PARAÍBA","40.2809055",4690,2046,2046,0,"2.9"
2512762,"RIACHÃO DO POÇO","NORDESTE","PARAÍBA","40.4597983",4738,2008,2008,0,"3"
2512788,"RIACHO DE SANTO ANTÔNIO","NORDESTE","PARAÍBA","93.6541211",1955,858,858,0,"3"
2512804,"RIACHO DOS CAVALOS","NORDESTE","PARAÍBA","262.531595",8493,3807,3807,0,"3"
2512903,"RIO TINTO","NORDESTE","PARAÍBA","465.2401853",24581,10088,10078,10,"3"
2513000,"SALGADINHO","NORDESTE","PARAÍBA","179.0045809",3355,1543,1542,1,"3"
2513109,"SALGADO DE SÃO FÉLIX","NORDESTE","PARAÍBA","204.0787779",11505,5363,5362,1,"2.8"
2513158,"SANTA CECÍLIA","NORDESTE","PARAÍBA","217.5772633",7670,3605,3605,0,"2.9"
2513208,"SANTA CRUZ","NORDESTE","PARAÍBA","217.6766096",5947,2684,2684,0,"2.9"
2513307,"SANTA HELENA","NORDESTE","PARAÍBA","211.143129",5865,2866,2863,3,"2.8"
2513356,"SANTA INÊS","NORDESTE","PARAÍBA","327.6347034",3227,1518,1517,1,"3"
2513406,"SANTA LUZIA","NORDESTE","PARAÍBA","440.7661737",14959,6728,6717,11,"2.8"
2513505,"SANTANA DE MANGUEIRA","NORDESTE","PARAÍBA","405.1642981",5010,2378,2377,1,"3.1"
2513604,"SANTANA DOS GARROTES","NORDESTE","PARAÍBA","361.4842034",6569,3180,3179,1,"2.9"
2513653,"JOCA CLAUDINO","NORDESTE","PARAÍBA","71.7993831",2539,1120,1120,0,"2.9"
2513703,"SANTA RITA","NORDESTE","PARAÍBA","718.575557",149910,59867,59840,27,"3"
2513802,"SANTA TERESINHA","NORDESTE","PARAÍBA","359.441585",4402,2152,2149,3,"3"
2513851,"SANTO ANDRÉ","NORDESTE","PARAÍBA","197.7912027",2622,1411,1411,0,"2.6"
2513901,"SÃO BENTO","NORDESTE","PARAÍBA","245.8396398",32235,13446,13437,9,"2.9"
2513927,"SÃO BENTINHO","NORDESTE","PARAÍBA","199.6349185",4327,1981,1980,1,"2.9"
2513943,"SÃO DOMINGOS DO CARIRI","NORDESTE","PARAÍBA","233.8353256",2585,1373,1373,0,"2.8"
2513968,"SÃO DOMINGOS","NORDESTE","PARAÍBA","170.3609196",2595,1234,1234,0,"2.8"
2513984,"SÃO FRANCISCO","NORDESTE","PARAÍBA","90.7241526",3137,1411,1411,0,"2.8"
2514008,"SÃO JOÃO DO CARIRI","NORDESTE","PARAÍBA","612.9657659",4226,2259,2258,1,"2.7"
2514107,"SÃO JOÃO DO TIGRE","NORDESTE","PARAÍBA","812.6165083",4263,2673,2672,1,"2.5"
2514206,"SÃO JOSÉ DA LAGOA TAPADA","NORDESTE","PARAÍBA","333.7236756",7126,3355,3353,2,"2.8"
2514305,"SÃO JOSÉ DE CAIANA","NORDESTE","PARAÍBA","183.2733118",5034,2373,2371,2,"3"
2514404,"SÃO JOSÉ DE ESPINHARAS","NORDESTE","PARAÍBA","726.7568634",4083,2045,2045,0,"3"
2514453,"SÃO JOSÉ DOS RAMOS","NORDESTE","PARAÍBA","100.6423715",5891,2477,2476,1,"3"
2514503,"SÃO JOSÉ DE PIRANHAS","NORDESTE","PARAÍBA","686.9181711",19067,8952,8946,6,"2.9"
2514552,"SÃO JOSÉ DE PRINCESA","NORDESTE","PARAÍBA","158.0520277",3416,1762,1762,0,"2.9"
2514602,"SÃO JOSÉ DO BONFIM","NORDESTE","PARAÍBA","153.6293739",3242,1656,1656,0,"2.9"
2514651,"SÃO JOSÉ DO BREJO DO CRUZ","NORDESTE","PARAÍBA","253.7874759",1699,716,716,0,"3.1"
2514701,"SÃO JOSÉ DO SABUGI","NORDESTE","PARAÍBA","213.5553655",4138,1805,1804,1,"2.9"
2514800,"SÃO JOSÉ DOS CORDEIROS","NORDESTE","PARAÍBA","376.6614336",3411,1945,1945,0,"2.6"
2514909,"SÃO MAMEDE","NORDESTE","PARAÍBA","533.4461177",7470,3742,3740,2,"2.8"
2515005,"SÃO MIGUEL DE TAIPU","NORDESTE","PARAÍBA","92.4129382",7066,3158,3158,0,"3.1"
2515104,"SÃO SEBASTIÃO DE LAGOA DE ROÇA","NORDESTE","PARAÍBA","46.3719127",11040,4733,4732,1,"2.9"
2515203,"SÃO SEBASTIÃO DO UMBUZEIRO","NORDESTE","PARAÍBA","464.3274235",3279,1923,1923,0,"2.6"
2515302,"SAPÉ","NORDESTE","PARAÍBA","313.6784606",51306,20115,20095,20,"3"
2515401,"SÃO VICENTE DO SERIDÓ","NORDESTE","PARAÍBA","262.7507265",10291,4388,4386,2,"3"
2515500,"SERRA BRANCA","NORDESTE","PARAÍBA","698.1024771",13614,7053,7047,6,"2.7"
2515609,"SERRA DA RAIZ","NORDESTE","PARAÍBA","31.678607",3094,1338,1337,1,"3.1"
2515708,"SERRA GRANDE","NORDESTE","PARAÍBA","64.3516855",2942,1491,1490,1,"2.8"
2515807,"SERRA REDONDA","NORDESTE","PARAÍBA","55.1968737",6828,3370,3370,0,"2.8"
2515906,"SERRARIA","NORDESTE","PARAÍBA","65.0620838",4885,2305,2301,4,"3"
2515930,"SERTÃOZINHO","NORDESTE","PARAÍBA","32.454718",5054,2241,2241,0,"2.9"
2515971,"SOBRADO","NORDESTE","PARAÍBA","61.953386",8236,3525,3525,0,"3"
2516003,"SOLÂNEA","NORDESTE","PARAÍBA","233.0428165",26774,12012,12002,10,"2.9"
2516102,"SOLEDADE","NORDESTE","PARAÍBA","578.1780577",13968,6439,6425,14,"2.9"
2516151,"SOSSÊGO","NORDESTE","PARAÍBA","147.2635845",3345,1605,1604,1,"2.9"
2516201,"SOUSA","NORDESTE","PARAÍBA","728.4915748",67259,28624,28606,18,"3"
2516300,"SUMÉ","NORDESTE","PARAÍBA","833.315213",17166,8982,8976,6,"2.6"
2516409,"TACIMA","NORDESTE","PARAÍBA","245.2364934",8010,3769,3769,0,"2.9"
2516508,"TAPEROÁ","NORDESTE","PARAÍBA","628.364603",14068,7326,7317,9,"2.8"
2516607,"TAVARES","NORDESTE","PARAÍBA","239.5065614",14101,6892,6888,4,"2.9"
2516706,"TEIXEIRA","NORDESTE","PARAÍBA","155.4518907",14631,6734,6730,4,"2.9"
2516755,"TENÓRIO","NORDESTE","PARAÍBA","87.4518125",2966,1451,1451,0,"2.8"
2516805,"TRIUNFO","NORDESTE","PARAÍBA","224.3355793",9892,4039,4038,1,"3.1"
2516904,"UIRAÚNA","NORDESTE","PARAÍBA","293.1818077",14930,6756,6751,5,"2.9"
2517001,"UMBUZEIRO","NORDESTE","PARAÍBA","185.5780898",9124,4130,4127,3,"3"
2517100,"VÁRZEA","NORDESTE","PARAÍBA","191.2823694",2668,1354,1352,2,"2.7"
2517209,"VIEIRÓPOLIS","NORDESTE","PARAÍBA","147.097991",4864,2216,2214,2,"3"
2517407,"ZABELÊ","NORDESTE","PARAÍBA","106.811211",2228,1283,1282,1,"2.7"
2600054,"ABREU E LIMA","NORDESTE","PERNAMBUCO","126.3842785",98462,41660,41637,23,"2.8"
2600104,"AFOGADOS DA INGAZEIRA","NORDESTE","PERNAMBUCO","377.6956253",40241,20057,20036,21,"2.7"
2600203,"AFRÂNIO","NORDESTE","PERNAMBUCO","1490.5938152",18674,8392,8389,3,"3.2"
2600302,"AGRESTINA","NORDESTE","PERNAMBUCO","200.36946",23779,11504,11503,1,"2.8"
2600401,"ÁGUA PRETA","NORDESTE","PERNAMBUCO","531.9354201",26461,11871,11868,3,"3"
2600500,"ÁGUAS BELAS","NORDESTE","PERNAMBUCO","885.9875897",41548,21183,21175,8,"3.1"
2600609,"ALAGOINHA","NORDESTE","PERNAMBUCO","214.2665814",13542,6534,6534,0,"2.8"
2600708,"ALIANÇA","NORDESTE","PERNAMBUCO","272.7725127",35741,14663,14662,1,"2.9"
2600807,"ALTINHO","NORDESTE","PERNAMBUCO","450.177506",20674,11128,11126,2,"2.6"
2600906,"AMARAJI","NORDESTE","PERNAMBUCO","233.2389113",18205,8622,8619,3,"2.8"
2601003,"ANGELIM","NORDESTE","PERNAMBUCO","118.0881828",10241,4503,4503,0,"2.9"
2601052,"ARAÇOIABA","NORDESTE","PERNAMBUCO","96.3603498",19243,7271,7268,3,"3.1"
2601102,"ARARIPINA","NORDESTE","PERNAMBUCO","2037.393914",85088,38919,38893,26,"3.1"
2601201,"ARCOVERDE","NORDESTE","PERNAMBUCO","343.9226107",77742,32395,32375,20,"2.8"
2601300,"BARRA DE GUABIRABA","NORDESTE","PERNAMBUCO","118.639232",12263,4771,4768,3,"3"
2601409,"BARREIROS","NORDESTE","PERNAMBUCO","233.4331627",40121,17248,17239,9,"3"
2601508,"BELÉM DE MARIA","NORDESTE","PERNAMBUCO","73.1447349",10378,4515,4514,1,"3"
2601607,"BELÉM DO SÃO FRANCISCO","NORDESTE","PERNAMBUCO","1830.7968865",18301,7838,7817,21,"3.3"
2601706,"BELO JARDIM","NORDESTE","PERNAMBUCO","647.4449152",79507,39030,39014,16,"2.7"
2601805,"BETÂNIA","NORDESTE","PERNAMBUCO","1244.073818",11232,5583,5579,4,"3"
2601904,"BEZERROS","NORDESTE","PERNAMBUCO","492.6323273",61694,31856,31847,9,"2.6"
2602001,"BODOCÓ","NORDESTE","PERNAMBUCO","1621.7859192",34478,15792,15787,5,"3.1"
2602100,"BOM CONSELHO","NORDESTE","PERNAMBUCO","792.1851388",44294,20435,20424,11,"2.9"
2602209,"BOM JARDIM","NORDESTE","PERNAMBUCO","224.1085123",37629,17606,17605,1,"2.8"
2602308,"BONITO","NORDESTE","PERNAMBUCO","393.1907132",37474,16920,16915,5,"2.8"
2602407,"BREJÃO","NORDESTE","PERNAMBUCO","159.7863225",9079,3936,3933,3,"3"
2602506,"BREJINHO","NORDESTE","PERNAMBUCO","106.0393929",7720,4016,4015,1,"2.7"
2602605,"BREJO DA MADRE DE DEUS","NORDESTE","PERNAMBUCO","762.3458111",48648,24650,24640,10,"2.8"
2602704,"BUENOS AIRES","NORDESTE","PERNAMBUCO","93.1871",12808,5398,5398,0,"2.9"
2602803,"BUÍQUE","NORDESTE","PERNAMBUCO","1336.5439873",52097,22154,22133,21,"3"
2602902,"CABO DE SANTO AGOSTINHO","NORDESTE","PERNAMBUCO","445.3858133",203440,99258,99210,48,"2.8"
2603009,"CABROBÓ","NORDESTE","PERNAMBUCO","1658.6156349",30294,13057,13049,8,"3"
2603108,"CACHOEIRINHA","NORDESTE","PERNAMBUCO","179.2616557",19899,9439,9427,12,"2.7"
2603207,"CAETÉS","NORDESTE","PERNAMBUCO","294.9461784",28827,11536,11530,6,"3.1"
2603306,"CALÇADO","NORDESTE","PERNAMBUCO","121.9450442",11093,4946,4942,4,"2.9"
2603405,"CALUMBI","NORDESTE","PERNAMBUCO","179.3139656",5228,2569,2569,0,"2.9"
2603454,"CAMARAGIBE","NORDESTE","PERNAMBUCO","51.3214025",147771,66583,66563,20,"2.8"
2603504,"CAMOCIM DE SÃO FÉLIX","NORDESTE","PERNAMBUCO","72.0100449",17419,7648,7642,6,"2.8"
2603603,"CAMUTANGA","NORDESTE","PERNAMBUCO","39.1162695",7750,3147,3145,2,"3"
2603702,"CANHOTINHO","NORDESTE","PERNAMBUCO","423.1675965",24329,9994,9988,6,"2.9"
2603801,"CAPOEIRAS","NORDESTE","PERNAMBUCO","337.1297217",18338,7770,7767,3,"3"
2603900,"CARNAÍBA","NORDESTE","PERNAMBUCO","427.8022229",18644,10209,10202,7,"2.7"
2603926,"CARNAUBEIRA DA PENHA","NORDESTE","PERNAMBUCO","1004.6673706",12239,4846,4844,2,"3.6"
2604007,"CARPINA","NORDESTE","PERNAMBUCO","147.0173614",79293,33293,33270,23,"2.9"
2604106,"CARUARU","NORDESTE","PERNAMBUCO","923.1496892",378048,178913,178858,55,"2.7"
2604155,"CASINHAS","NORDESTE","PERNAMBUCO","115.8676685",12967,5456,5456,0,"3.1"
2604205,"CATENDE","NORDESTE","PERNAMBUCO","208.5936546",32156,13967,13961,6,"3"
2604304,"CEDRO","NORDESTE","PERNAMBUCO","148.7460023",10518,4415,4405,10,"3.1"
2604403,"CHÃ DE ALEGRIA","NORDESTE","PERNAMBUCO","49.3265784",12984,5279,5279,0,"3"
2604502,"CHÃ GRANDE","NORDESTE","PERNAMBUCO","84.7874725",20546,9464,9462,2,"2.8"
2604601,"CONDADO","NORDESTE","PERNAMBUCO","89.644588",24587,9882,9878,4,"3"
2604700,"CORRENTES","NORDESTE","PERNAMBUCO","317.7933583",17131,6439,6439,0,"3.3"
2604809,"CORTÊS","NORDESTE","PERNAMBUCO","102.8516566",10198,4477,4473,4,"2.8"
2604908,"CUMARU","NORDESTE","PERNAMBUCO","292.2312179",15920,7752,7750,2,"2.8"
2605004,"CUPIRA","NORDESTE","PERNAMBUCO","95.1552979",23518,10832,10832,0,"2.8"
2605103,"CUSTÓDIA","NORDESTE","PERNAMBUCO","1404.1263196",37699,18018,18006,12,"2.8"
2605152,"DORMENTES","NORDESTE","PERNAMBUCO","1539.0522456",17188,8277,8276,1,"3"
2605202,"ESCADA","NORDESTE","PERNAMBUCO","342.5840428",59891,25714,25699,15,"2.8"
2605301,"EXU","NORDESTE","PERNAMBUCO","1336.7857931",31843,15077,15074,3,"3.1"
2605400,"FEIRA NOVA","NORDESTE","PERNAMBUCO","107.7256516",21427,9844,9843,1,"2.8"
2605459,"FERNANDO DE NORONHA","NORDESTE","PERNAMBUCO","18.6094747",3167,1137,834,303,"3"
2605509,"FERREIROS","NORDESTE","PERNAMBUCO","92.5164035",15026,6048,6043,5,"3"
2605608,"FLORES","NORDESTE","PERNAMBUCO","995.5581784",20347,11292,11289,3,"2.7"
2605707,"FLORESTA","NORDESTE","PERNAMBUCO","3604.9477132",30137,12553,12545,8,"3.2"
2605806,"FREI MIGUELINHO","NORDESTE","PERNAMBUCO","212.7071283",13636,7255,7252,3,"2.6"
2605905,"GAMELEIRA","NORDESTE","PERNAMBUCO","257.780944",18214,7748,7744,4,"2.9"
2606002,"GARANHUNS","NORDESTE","PERNAMBUCO","458.5516016",142506,61356,61312,44,"2.9"
2606101,"GLÓRIA DO GOITÁ","NORDESTE","PERNAMBUCO","234.7084408",29347,13426,13425,1,"2.9"
2606200,"GOIANA","NORDESTE","PERNAMBUCO","445.4048609",81055,41466,41409,57,"2.9"
2606309,"GRANITO","NORDESTE","PERNAMBUCO","521.6899732",6967,3122,3120,2,"3.1"
2606408,"GRAVATÁ","NORDESTE","PERNAMBUCO","507.3600271",86516,49982,49956,26,"2.7"
2606507,"IATI","NORDESTE","PERNAMBUCO","635.1370295",17165,7692,7692,0,"3"
2606606,"IBIMIRIM","NORDESTE","PERNAMBUCO","1882.4980541",26593,11406,11399,7,"3"
2606705,"IBIRAJUBA","NORDESTE","PERNAMBUCO","189.5958186",7140,3683,3683,0,"2.7"
2606804,"IGARASSU","NORDESTE","PERNAMBUCO","306.8786229",115196,51071,51049,22,"2.8"
2606903,"IGUARACY","NORDESTE","PERNAMBUCO","838.1317837",11081,5892,5892,0,"2.7"
2607000,"INAJÁ","NORDESTE","PERNAMBUCO","1231.3620564",25603,8477,8474,3,"3.5"
2607109,"INGAZEIRA","NORDESTE","PERNAMBUCO","243.5857221",4765,2358,2356,2,"2.8"
2607208,"IPOJUCA","NORDESTE","PERNAMBUCO","521.8008045",98932,50374,50192,182,"3"
2607307,"IPUBI","NORDESTE","PERNAMBUCO","693.9144124",29009,12361,12356,5,"3.1"
2607406,"ITACURUBA","NORDESTE","PERNAMBUCO","430.0379556",4284,1950,1950,0,"3.2"
2607505,"ITAÍBA","NORDESTE","PERNAMBUCO","1061.6941771",32650,12059,12056,3,"3"
2607604,"ILHA DE ITAMARACÁ","NORDESTE","PERNAMBUCO","66.1464127",24540,25210,25190,20,"2.8"
2607653,"ITAMBÉ","NORDESTE","PERNAMBUCO","304.0055879",34935,14041,14036,5,"3"
2607703,"ITAPETIM","NORDESTE","PERNAMBUCO","411.9012432",13791,8305,8301,4,"2.5"
2607752,"ITAPISSUMA","NORDESTE","PERNAMBUCO","73.9683995",27749,9539,9529,10,"2.9"
2607802,"ITAQUITINGA","NORDESTE","PERNAMBUCO","162.7390659",16554,6382,6380,2,"3"
2607901,"JABOATÃO DOS GUARARAPES","NORDESTE","PERNAMBUCO","258.7237492",644037,294040,293978,62,"2.7"
2607950,"JAQUEIRA","NORDESTE","PERNAMBUCO","87.2084566",10247,4088,4087,1,"3.1"
2608008,"JATAÚBA","NORDESTE","PERNAMBUCO","714.6010239",15843,8552,8549,3,"2.7"
2608057,"JATOBÁ","NORDESTE","PERNAMBUCO","277.8623248",14020,6338,6334,4,"3"
2608107,"JOÃO ALFREDO","NORDESTE","PERNAMBUCO","134.1472399",27725,14282,14282,0,"2.7"
2608206,"JOAQUIM NABUCO","NORDESTE","PERNAMBUCO","122.5919807",13269,5394,5392,2,"3"
2608255,"JUCATI","NORDESTE","PERNAMBUCO","120.5273781",11517,4779,4779,0,"3"
2608305,"JUPI","NORDESTE","PERNAMBUCO","104.8347329",15329,6642,6641,1,"2.9"
2608404,"JUREMA","NORDESTE","PERNAMBUCO","148.2537221",13648,7041,7041,0,"2.8"
2608453,"LAGOA DO CARRO","NORDESTE","PERNAMBUCO","69.6655563",17981,7841,7839,2,"2.8"
2608503,"LAGOA DE ITAENGA","NORDESTE","PERNAMBUCO","56.13082",19003,8376,8375,1,"2.8"
2608602,"LAGOA DO OURO","NORDESTE","PERNAMBUCO","198.7616519",11933,5416,5413,3,"2.9"
2608701,"LAGOA DOS GATOS","NORDESTE","PERNAMBUCO","224.9474444",14076,7234,7230,4,"2.8"
2608750,"LAGOA GRANDE","NORDESTE","PERNAMBUCO","1850.0697499",24088,10316,10313,3,"3"
2608800,"LAJEDO","NORDESTE","PERNAMBUCO","189.0957393",39582,17666,17660,6,"2.8"
2608909,"LIMOEIRO","NORDESTE","PERNAMBUCO","273.733025",56510,24843,24830,13,"2.7"
2609006,"MACAPARANA","NORDESTE","PERNAMBUCO","108.0485091",23879,9322,9312,10,"3"
2609105,"MACHADOS","NORDESTE","PERNAMBUCO","61.6194562",11333,4703,4699,4,"2.9"
2609154,"MANARI","NORDESTE","PERNAMBUCO","344.6845999",23763,7480,7477,3,"3.5"
2609204,"MARAIAL","NORDESTE","PERNAMBUCO","199.8646977",9359,4362,4358,4,"3"
2609303,"MIRANDIBA","NORDESTE","PERNAMBUCO","821.6755789",14166,6251,6249,2,"3.2"
2609402,"MORENO","NORDESTE","PERNAMBUCO","194.1966117",55292,23830,23826,4,"2.8"
2609501,"NAZARÉ DA MATA","NORDESTE","PERNAMBUCO","130.5720283",30648,12651,12644,7,"2.9"
2609600,"OLINDA","NORDESTE","PERNAMBUCO","41.3001333",349976,153234,153155,79,"2.7"
2609709,"OROBÓ","NORDESTE","PERNAMBUCO","138.5209622",21808,9722,9719,3,"2.9"
2609808,"OROCÓ","NORDESTE","PERNAMBUCO","554.7594617",13613,5850,5844,6,"3.2"
2609907,"OURICURI","NORDESTE","PERNAMBUCO","2381.5697013",65245,32040,32007,33,"3"
2610004,"PALMARES","NORDESTE","PERNAMBUCO","339.4012473",54584,23734,23714,20,"2.9"
2610103,"PALMEIRINA","NORDESTE","PERNAMBUCO","168.7960829",7031,3384,3383,1,"2.8"
2610202,"PANELAS","NORDESTE","PERNAMBUCO","380.4281842",22991,11822,11821,1,"2.8"
2610301,"PARANATAMA","NORDESTE","PERNAMBUCO","185.3714785",12199,5455,5452,3,"2.9"
2610400,"PARNAMIRIM","NORDESTE","PERNAMBUCO","2609.5480762",18612,9120,9105,15,"3.1"
2610509,"PASSIRA","NORDESTE","PERNAMBUCO","327.2103643",28340,13411,13406,5,"2.7"
2610608,"PAUDALHO","NORDESTE","PERNAMBUCO","269.6509819",56665,23630,23622,8,"3"
2610707,"PAULISTA","NORDESTE","PERNAMBUCO","96.932406",342167,157688,157659,29,"2.7"
2610806,"PEDRA","NORDESTE","PERNAMBUCO","922.601626",22795,9666,9663,3,"2.9"
2610905,"PESQUEIRA","NORDESTE","PERNAMBUCO","960.0417093",62722,29617,29600,17,"2.8"
2611002,"PETROLÂNDIA","NORDESTE","PERNAMBUCO","1056.5889323",34161,14047,14031,16,"3.1"
2611101,"PETROLINA","NORDESTE","PERNAMBUCO","4561.8698062",386791,159256,159154,102,"3"
2611200,"POÇÃO","NORDESTE","PERNAMBUCO","205.1185283",10500,5515,5515,0,"2.7"
2611309,"POMBOS","NORDESTE","PERNAMBUCO","239.8315946",27552,12835,12834,1,"2.8"
2611408,"PRIMAVERA","NORDESTE","PERNAMBUCO","113.1348641",13838,5255,5251,4,"3.1"
2611507,"QUIPAPÁ","NORDESTE","PERNAMBUCO","230.6173712",17928,8144,8141,3,"2.9"
2611533,"QUIXABA","NORDESTE","PERNAMBUCO","210.7049807",6554,3365,3364,1,"2.9"
2611606,"RECIFE","NORDESTE","PERNAMBUCO","218.8429561",1488920,644213,643590,623,"2.7"
2611705,"RIACHO DAS ALMAS","NORDESTE","PERNAMBUCO","314.002743",20639,11630,11630,0,"2.7"
2611804,"RIBEIRÃO","NORDESTE","PERNAMBUCO","289.5658865",33507,15036,15017,19,"2.8"
2611903,"RIO FORMOSO","NORDESTE","PERNAMBUCO","227.4578003",20009,7698,7691,7,"3.1"
2612000,"SAIRÉ","NORDESTE","PERNAMBUCO","190.4546241",10887,6585,6583,2,"2.6"
2612109,"SALGADINHO","NORDESTE","PERNAMBUCO","87.2172802",5727,2747,2746,1,"2.8"
2612208,"SALGUEIRO","NORDESTE","PERNAMBUCO","1678.5635645",62372,26889,26834,55,"3"
2612307,"SALOÁ","NORDESTE","PERNAMBUCO","251.5492112",13836,6285,6277,8,"2.9"
2612406,"SANHARÓ","NORDESTE","PERNAMBUCO","268.0650532",18624,8438,8438,0,"2.8"
2612455,"SANTA CRUZ","NORDESTE","PERNAMBUCO","1245.9833167",13841,6026,6017,9,"3.2"
2612471,"SANTA CRUZ DA BAIXA VERDE","NORDESTE","PERNAMBUCO","114.9314235",11567,5946,5945,1,"2.9"
2612505,"SANTA CRUZ DO CAPIBARIBE","NORDESTE","PERNAMBUCO","335.308544",98254,42718,42696,22,"2.8"
2612554,"SANTA FILOMENA","NORDESTE","PERNAMBUCO","1005.3408563",12106,6135,6135,0,"3"
2612604,"SANTA MARIA DA BOA VISTA","NORDESTE","PERNAMBUCO","3000.7738218",40578,16319,16287,32,"3.2"
2612703,"SANTA MARIA DO CAMBUCÁ","NORDESTE","PERNAMBUCO","92.1479096",14013,6785,6784,1,"2.8"
2612802,"SANTA TEREZINHA","NORDESTE","PERNAMBUCO","200.3265265",10244,5314,5314,0,"2.7"
2612901,"SÃO BENEDITO DO SUL","NORDESTE","PERNAMBUCO","160.4770557",13113,4795,4789,6,"3.4"
2613008,"SÃO BENTO DO UNA","NORDESTE","PERNAMBUCO","719.1479689",49449,22572,22564,8,"2.9"
2613107,"SÃO CAITANO","NORDESTE","PERNAMBUCO","382.4825614",37126,19182,19178,4,"2.8"
2613206,"SÃO JOÃO","NORDESTE","PERNAMBUCO","258.5185725",23837,9994,9993,1,"3"
2613305,"SÃO JOAQUIM DO MONTE","NORDESTE","PERNAMBUCO","227.3847801",20037,9413,9410,3,"2.8"
2613404,"SÃO JOSÉ DA COROA GRANDE","NORDESTE","PERNAMBUCO","69.1836454",18825,11660,11634,26,"3.1"
2613503,"SÃO JOSÉ DO BELMONTE","NORDESTE","PERNAMBUCO","1474.0855272",34843,16790,16782,8,"3"
2613602,"SÃO JOSÉ DO EGITO","NORDESTE","PERNAMBUCO","774.0372222",31004,16072,16061,11,"2.6"
2613701,"SÃO LOURENÇO DA MATA","NORDESTE","PERNAMBUCO","263.6868738",111249,51431,51388,43,"2.8"
2613800,"SÃO VICENTE FÉRRER","NORDESTE","PERNAMBUCO","112.5543614",16677,6830,6829,1,"2.9"
2613909,"SERRA TALHADA","NORDESTE","PERNAMBUCO","2980.0069184",92228,43638,43604,34,"2.8"
2614006,"SERRITA","NORDESTE","PERNAMBUCO","1535.1903629",18207,8111,8108,3,"3.3"
2614105,"SERTÂNIA","NORDESTE","PERNAMBUCO","2421.5270792",32811,16397,16383,14,"2.8"
2614204,"SIRINHAÉM","NORDESTE","PERNAMBUCO","374.3212158",37596,15823,15786,37,"3.2"
2614303,"MOREILÂNDIA","NORDESTE","PERNAMBUCO","404.2869831",10540,4710,4707,3,"3"
2614402,"SOLIDÃO","NORDESTE","PERNAMBUCO","138.3984638",5210,2727,2723,4,"2.9"
2614501,"SURUBIM","NORDESTE","PERNAMBUCO","252.8962178",64120,28761,28741,20,"2.8"
2614600,"TABIRA","NORDESTE","PERNAMBUCO","390.4340535",27681,13811,13801,10,"2.8"
2614709,"TACAIMBÓ","NORDESTE","PERNAMBUCO","227.6005849",13738,6988,6986,2,"2.7"
2614808,"TACARATU","NORDESTE","PERNAMBUCO","1264.5321184",23902,9939,9934,5,"3.3"
2614857,"TAMANDARÉ","NORDESTE","PERNAMBUCO","213.7496959",23561,16747,16692,55,"3.1"
2615003,"TAQUARITINGA DO NORTE","NORDESTE","PERNAMBUCO","475.1834321",24736,13632,13621,11,"2.8"
2615102,"TEREZINHA","NORDESTE","PERNAMBUCO","151.4497371",6513,2806,2805,1,"3"
2615201,"TERRA NOVA","NORDESTE","PERNAMBUCO","318.7092301",8920,3555,3553,2,"3.1"
2615300,"TIMBAÚBA","NORDESTE","PERNAMBUCO","287.682631",46147,19212,19196,16,"2.8"
2615409,"TORITAMA","NORDESTE","PERNAMBUCO","25.704158",41137,16963,16960,3,"2.9"
2615508,"TRACUNHAÉM","NORDESTE","PERNAMBUCO","137.3210029",13867,5610,5610,0,"3"
2615607,"TRINDADE","NORDESTE","PERNAMBUCO","295.7654305",30321,13982,13975,7,"3.1"
2615706,"TRIUNFO","NORDESTE","PERNAMBUCO","191.5183514",14705,7500,7479,21,"2.8"
2615805,"TUPANATINGA","NORDESTE","PERNAMBUCO","934.8009837",26937,9057,9054,3,"3.4"
2615904,"TUPARETAMA","NORDESTE","PERNAMBUCO","189.5094943",8005,3925,3922,3,"2.7"
2616001,"VENTUROSA","NORDESTE","PERNAMBUCO","336.1068393",17251,6952,6950,2,"3"
2616100,"VERDEJANTE","NORDESTE","PERNAMBUCO","476.0389733",9169,4278,4277,1,"3.1"
2616183,"VERTENTE DO LÉRIO","NORDESTE","PERNAMBUCO","73.6307025",7558,3706,3706,0,"2.8"
2616209,"VERTENTES","NORDESTE","PERNAMBUCO","196.3247502",21959,10046,10043,3,"2.8"
2616308,"VICÊNCIA","NORDESTE","PERNAMBUCO","228.0170728",26359,11274,11271,3,"2.9"
2616407,"VITÓRIA DE SANTO ANTÃO","NORDESTE","PERNAMBUCO","336.5728298",134084,59368,59344,24,"2.8"
2616506,"XEXÉU","NORDESTE","PERNAMBUCO","110.8146885",11611,5185,5185,0,"2.9"
2700102,"ÁGUA BRANCA","NORDESTE","ALAGOAS","468.2282463",19008,8244,8241,3,"3.3"
2700201,"ANADIA","NORDESTE","ALAGOAS","186.1344036",13966,6474,6473,1,"2.9"
2700300,"ARAPIRACA","NORDESTE","ALAGOAS","345.6547024",234696,96116,96045,71,"3"
2700409,"ATALAIA","NORDESTE","ALAGOAS","533.2575736",37512,14735,14732,3,"3.1"
2700508,"BARRA DE SANTO ANTÔNIO","NORDESTE","ALAGOAS","131.3637424",16365,7733,7718,15,"3.1"
2700607,"BARRA DE SÃO MIGUEL","NORDESTE","ALAGOAS","74.2470245",7944,6306,6279,27,"3.1"
2700706,"BATALHA","NORDESTE","ALAGOAS","315.8691823",16448,6627,6622,5,"3.2"
2700805,"BELÉM","NORDESTE","ALAGOAS","66.6287808",4722,2170,2170,0,"2.8"
2700904,"BELO MONTE","NORDESTE","ALAGOAS","334.1363691",5936,2901,2901,0,"3.2"
2701001,"BOCA DA MATA","NORDESTE","ALAGOAS","193.0020788",21187,8673,8671,2,"3"
2701100,"BRANQUINHA","NORDESTE","ALAGOAS","168.0484572",9603,4467,4466,1,"3"
2701209,"CACIMBINHAS","NORDESTE","ALAGOAS","281.6919462",10482,4623,4623,0,"2.9"
2701308,"CAJUEIRO","NORDESTE","ALAGOAS","94.35687",16024,5967,5964,3,"3.2"
2701357,"CAMPESTRE","NORDESTE","ALAGOAS","65.9102435",6665,2501,2500,1,"3.2"
2701407,"CAMPO ALEGRE","NORDESTE","ALAGOAS","312.7263218",32106,12176,12162,14,"3.1"
2701506,"CAMPO GRANDE","NORDESTE","ALAGOAS","170.1440065",8143,3380,3378,2,"3.1"
2701605,"CANAPI","NORDESTE","ALAGOAS","602.7781115",15559,7778,7777,1,"3.1"
2701704,"CAPELA","NORDESTE","ALAGOAS","263.7347475",15032,5612,5609,3,"3.2"
2701803,"CARNEIROS","NORDESTE","ALAGOAS","111.6953999",8999,3599,3599,0,"3.3"
2701902,"CHÃ PRETA","NORDESTE","ALAGOAS","157.8310042",5910,2551,2551,0,"3"
2702009,"COITÉ DO NÓIA","NORDESTE","ALAGOAS","88.758767",10810,4576,4575,1,"3"
2702108,"COLÔNIA LEOPOLDINA","NORDESTE","ALAGOAS","207.9346187",15816,6570,6562,8,"3.1"
2702207,"COQUEIRO SECO","NORDESTE","ALAGOAS","39.608089",5581,2239,2239,0,"3"
2702306,"CORURIPE","NORDESTE","ALAGOAS","897.799722",50414,21504,21483,21,"3.1"
2702355,"CRAÍBAS","NORDESTE","ALAGOAS","278.878969",25397,10095,10093,2,"3.1"
2702405,"DELMIRO GOUVEIA","NORDESTE","ALAGOAS","628.5466326",51318,23341,23327,14,"3"
2702504,"DOIS RIACHOS","NORDESTE","ALAGOAS","141.6206529",9805,4199,4198,1,"3"
2702553,"ESTRELA DE ALAGOAS","NORDESTE","ALAGOAS","260.7715648",15429,7516,7514,2,"2.8"
2702603,"FEIRA GRANDE","NORDESTE","ALAGOAS","175.9056741",22712,9372,9371,1,"3.1"
2702702,"FELIZ DESERTO","NORDESTE","ALAGOAS","110.0615636",3963,1872,1868,4,"3"
2702801,"FLEXEIRAS","NORDESTE","ALAGOAS","333.7561884",9618,4027,4024,3,"3.1"
2702900,"GIRAU DO PONCIANO","NORDESTE","ALAGOAS","513.4542539",36102,13980,13978,2,"3.2"
2703007,"IBATEGUARA","NORDESTE","ALAGOAS","265.3123428",13731,6067,6066,1,"3"
2703106,"IGACI","NORDESTE","ALAGOAS","334.3462724",23995,10892,10891,1,"2.8"
2703205,"IGREJA NOVA","NORDESTE","ALAGOAS","426.5382944",21372,9090,9090,0,"3"
2703304,"INHAPI","NORDESTE","ALAGOAS","372.0191221",15167,6696,6695,1,"3.2"
2703403,"JACARÉ DOS HOMENS","NORDESTE","ALAGOAS","148.9918085",5083,2183,2183,0,"3.1"
2703502,"JACUÍPE","NORDESTE","ALAGOAS","208.738356",5352,2266,2262,4,"3"
2703601,"JAPARATINGA","NORDESTE","ALAGOAS","85.3564501",9219,4497,4465,32,"3.2"
2703700,"JARAMATAIA","NORDESTE","ALAGOAS","105.4156776",4985,2073,2072,1,"3.1"
2703759,"JEQUIÁ DA PRAIA","NORDESTE","ALAGOAS","334.265507",9470,3984,3982,2,"3.2"
2703809,"JOAQUIM GOMES","NORDESTE","ALAGOAS","298.1702008",17150,7013,7008,5,"3.2"
2703908,"JUNDIÁ","NORDESTE","ALAGOAS","88.7934395",4092,1751,1751,0,"3"
2704005,"JUNQUEIRO","NORDESTE","ALAGOAS","247.7238953",23907,10214,10213,1,"3"
2704104,"LAGOA DA CANOA","NORDESTE","ALAGOAS","83.6214195",18457,7329,7329,0,"3.1"
2704203,"LIMOEIRO DE ANADIA","NORDESTE","ALAGOAS","309.2052461",24740,10089,10089,0,"3.1"
2704302,"MACEIÓ","NORDESTE","ALAGOAS","509.3203217",957916,403096,402846,250,"2.8"
2704401,"MAJOR ISIDORO","NORDESTE","ALAGOAS","442.744174",17700,7538,7537,1,"3"
2704500,"MARAGOGI","NORDESTE","ALAGOAS","334.1649788",32174,16914,16826,88,"3.2"
2704609,"MARAVILHA","NORDESTE","ALAGOAS","332.3703056",9534,4887,4886,1,"3"
2704708,"MARECHAL DEODORO","NORDESTE","ALAGOAS","340.9795746",60370,28439,28406,33,"3.1"
2704807,"MARIBONDO","NORDESTE","ALAGOAS","180.1072929",13679,5211,5206,5,"3.1"
2704906,"MAR VERMELHO","NORDESTE","ALAGOAS","91.741248",3155,1384,1383,1,"3"
2705002,"MATA GRANDE","NORDESTE","ALAGOAS","914.722234",21844,10531,10530,1,"3.1"
2705101,"MATRIZ DE CAMARAGIBE","NORDESTE","ALAGOAS","238.1128458",23857,8690,8676,14,"3.2"
2705200,"MESSIAS","NORDESTE","ALAGOAS","114.1561747",15405,6119,6116,3,"3.1"
2705309,"MINADOR DO NEGRÃO","NORDESTE","ALAGOAS","167.4615365",4845,2023,2023,0,"3"
2705408,"MONTEIRÓPOLIS","NORDESTE","ALAGOAS","86.6045415",7184,2969,2969,0,"3.2"
2705507,"MURICI","NORDESTE","ALAGOAS","418.0277887",25187,9528,9522,6,"3.3"
2705606,"NOVO LINO","NORDESTE","ALAGOAS","215.5471155",10020,4214,4214,0,"3.1"
2705705,"OLHO D'ÁGUA DAS FLORES","NORDESTE","ALAGOAS","188.2216232",20695,9140,9134,6,"3"
2705804,"OLHO D'ÁGUA DO CASADO","NORDESTE","ALAGOAS","327.6784677",8349,3814,3814,0,"3.2"
2705903,"OLHO D'ÁGUA GRANDE","NORDESTE","ALAGOAS","117.0059997",4330,1830,1830,0,"3.1"
2706000,"OLIVENÇA","NORDESTE","ALAGOAS","175.2872025",10812,5004,5004,0,"3"
2706109,"OURO BRANCO","NORDESTE","ALAGOAS","196.5602942",11446,5524,5522,2,"2.9"
2706208,"PALESTINA","NORDESTE","ALAGOAS","38.1890857",4325,1699,1699,0,"3.3"
2706307,"PALMEIRA DOS ÍNDIOS","NORDESTE","ALAGOAS","450.9896464",71574,30820,30807,13,"2.9"
2706406,"PÃO DE AÇÚCAR","NORDESTE","ALAGOAS","688.8702736",23823,10124,10117,7,"3.1"
2706422,"PARICONHA","NORDESTE","ALAGOAS","254.7188622",10573,4758,4756,2,"3.2"
2706448,"PARIPUEIRA","NORDESTE","ALAGOAS","92.7881234",13835,7339,7331,8,"3.2"
2706505,"PASSO DE CAMARAGIBE","NORDESTE","ALAGOAS","251.2900039",13804,5710,5696,14,"3.3"
2706604,"PAULO JACINTO","NORDESTE","ALAGOAS","118.4567844",6576,2966,2966,0,"2.9"
2706703,"PENEDO","NORDESTE","ALAGOAS","688.4523313",58650,24995,24968,27,"3"
2706802,"PIAÇABUÇU","NORDESTE","ALAGOAS","243.6864482",15908,7955,7942,13,"3"
2706901,"PILAR","NORDESTE","ALAGOAS","259.6136538",35370,14265,14255,10,"3"
2707008,"PINDOBA","NORDESTE","ALAGOAS","117.0855828",2731,1077,1077,0,"3.3"
2707107,"PIRANHAS","NORDESTE","ALAGOAS","403.9945825",22609,9802,9780,22,"3.2"
2707206,"POÇO DAS TRINCHEIRAS","NORDESTE","ALAGOAS","284.2600943",12518,5325,5323,2,"3.1"
2707305,"PORTO CALVO","NORDESTE","ALAGOAS","313.2306293",24071,9300,9294,6,"3.2"
2707404,"PORTO DE PEDRAS","NORDESTE","ALAGOAS","257.1049901",9295,4183,4127,56,"3.3"
2707503,"PORTO REAL DO COLÉGIO","NORDESTE","ALAGOAS","235.8522459",20082,8551,8548,3,"3.1"
2707602,"QUEBRANGULO","NORDESTE","ALAGOAS","319.8289047",11080,4827,4823,4,"3"
2707701,"RIO LARGO","NORDESTE","ALAGOAS","293.815712",93927,38420,38413,7,"3"
2707800,"ROTEIRO","NORDESTE","ALAGOAS","128.9260226",6474,2243,2243,0,"3.3"
2707909,"SANTA LUZIA DO NORTE","NORDESTE","ALAGOAS","28.8571273",6919,2643,2643,0,"3.2"
2708006,"SANTANA DO IPANEMA","NORDESTE","ALAGOAS","436.1596561",46220,19459,19444,15,"3.1"
2708105,"SANTANA DO MUNDAÚ","NORDESTE","ALAGOAS","232.1688961",11323,4959,4958,1,"3"
2708204,"SÃO BRÁS","NORDESTE","ALAGOAS","139.0384067",6555,3571,3571,0,"3.1"
2708303,"SÃO JOSÉ DA LAJE","NORDESTE","ALAGOAS","256.6032028",20813,8197,8192,5,"3"
2708402,"SÃO JOSÉ DA TAPERA","NORDESTE","ALAGOAS","490.8799218",30604,13162,13156,6,"3.2"
2708501,"SÃO LUÍS DO QUITUNDE","NORDESTE","ALAGOAS","397.2574143",30873,10803,10795,8,"3.3"
2708600,"SÃO MIGUEL DOS CAMPOS","NORDESTE","ALAGOAS","335.6829223",51990,19308,19293,15,"3.1"
2708709,"SÃO MIGUEL DOS MILAGRES","NORDESTE","ALAGOAS","76.7310872",8482,4038,3951,87,"3.2"
2708808,"SÃO SEBASTIÃO","NORDESTE","ALAGOAS","314.9240333",31786,13474,13468,6,"3"
2708907,"SATUBA","NORDESTE","ALAGOAS","41.2676783",24278,9263,9261,2,"3.1"
2708956,"SENADOR RUI PALMEIRA","NORDESTE","ALAGOAS","338.568539",12303,4818,4818,0,"3.3"
2709004,"TANQUE D'ARCA","NORDESTE","ALAGOAS","124.6162904",5796,2841,2841,0,"2.8"
2709103,"TAQUARANA","NORDESTE","ALAGOAS","153.8412607",19032,8593,8593,0,"2.9"
2709152,"TEOTÔNIO VILELA","NORDESTE","ALAGOAS","299.2215037",38053,14783,14774,9,"3.1"
2709202,"TRAIPU","NORDESTE","ALAGOAS","681.5766822",23565,9978,9975,3,"3.2"
2709301,"UNIÃO DOS PALMARES","NORDESTE","ALAGOAS","420.3759283",59280,25138,25124,14,"3"
2709400,"VIÇOSA","NORDESTE","ALAGOAS","367.8885035",24092,9954,9947,7,"3"
2800100,"AMPARO DO SÃO FRANCISCO","NORDESTE","SERGIPE","35.682623",2170,972,971,1,"2.9"
2800209,"AQUIDABÃ","NORDESTE","SERGIPE","359.5430455",20131,10188,10182,6,"2.7"
2800308,"ARACAJU","NORDESTE","SERGIPE","182.1631576",602757,267071,266933,138,"2.8"
2800407,"ARAUÁ","NORDESTE","SERGIPE","198.9668844",10318,4762,4760,2,"2.8"
2800506,"AREIA BRANCA","NORDESTE","SERGIPE","148.1345219",18081,7692,7686,6,"2.8"
2800605,"BARRA DOS COQUEIROS","NORDESTE","SERGIPE","92.2682991",41511,20170,20167,3,"2.9"
2800670,"BOQUIM","NORDESTE","SERGIPE","205.442863",24636,11124,11118,6,"2.8"
2800704,"BREJO GRANDE","NORDESTE","SERGIPE","141.4640956",7841,3547,3543,4,"3.2"
2801009,"CAMPO DO BRITO","NORDESTE","SERGIPE","201.5184666",18149,8861,8857,4,"2.7"
2801108,"CANHOBA","NORDESTE","SERGIPE","171.5811267",3791,1868,1868,0,"3"
2801207,"CANINDÉ DE SÃO FRANCISCO","NORDESTE","SERGIPE","934.1670283",26834,11909,11889,20,"3.1"
2801306,"CAPELA","NORDESTE","SERGIPE","442.210458",31645,14512,14509,3,"2.9"
2801405,"CARIRA","NORDESTE","SERGIPE","638.7434488",19939,9668,9665,3,"2.7"
2801504,"CARMÓPOLIS","NORDESTE","SERGIPE","46.3953724",13853,6140,6131,9,"3"
2801603,"CEDRO DE SÃO JOÃO","NORDESTE","SERGIPE","83.7104653",5391,2552,2552,0,"2.8"
2801702,"CRISTINÁPOLIS","NORDESTE","SERGIPE","228.5561506",17100,7334,7328,6,"3"
2801900,"CUMBE","NORDESTE","SERGIPE","128.3931732",3824,2037,2037,0,"2.8"
2802007,"DIVINA PASTORA","NORDESTE","SERGIPE","90.508087",4340,1888,1888,0,"3"
2802106,"ESTÂNCIA","NORDESTE","SERGIPE","647.3437458",65078,32868,32839,29,"2.8"
2802205,"FEIRA NOVA","NORDESTE","SERGIPE","183.2645755",5975,2930,2929,1,"2.8"
2802304,"FREI PAULO","NORDESTE","SERGIPE","399.1780047",14530,6504,6500,4,"2.9"
2802403,"GARARU","NORDESTE","SERGIPE","656.9559071",11096,5718,5716,2,"2.8"
2802502,"GENERAL MAYNARD","NORDESTE","SERGIPE","19.7928671",3037,1441,1441,0,"2.7"
2802601,"GRACCHO CARDOSO","NORDESTE","SERGIPE","242.6793276",5834,3072,3072,0,"2.8"
2802700,"ILHA DAS FLORES","NORDESTE","SERGIPE","52.6929214",8321,3497,3495,2,"3"
2802809,"INDIAROBA","NORDESTE","SERGIPE","316.3161565",16549,6993,6984,9,"3.1"
2802908,"ITABAIANA","NORDESTE","SERGIPE","337.3482047",103440,44394,44362,32,"2.7"
2803005,"ITABAIANINHA","NORDESTE","SERGIPE","501.794143",40678,17052,17042,10,"3"
2803104,"ITABI","NORDESTE","SERGIPE","183.4216476",4745,2667,2666,1,"2.6"
2803203,"ITAPORANGA D'AJUDA","NORDESTE","SERGIPE","739.7020566",34411,18682,18662,20,"2.8"
2803302,"JAPARATUBA","NORDESTE","SERGIPE","365.6770735",16209,7551,7544,7,"2.9"
2803401,"JAPOATÃ","NORDESTE","SERGIPE","402.3527251",13407,6049,6044,5,"2.9"
2803500,"LAGARTO","NORDESTE","SERGIPE","968.9207314",101579,46412,46390,22,"2.8"
2803609,"LARANJEIRAS","NORDESTE","SERGIPE","162.2728493",23975,9464,9463,1,"3.1"
2803708,"MACAMBIRA","NORDESTE","SERGIPE","137.495848",6838,3345,3345,0,"2.7"
2803807,"MALHADA DOS BOIS","NORDESTE","SERGIPE","63.1990877",3579,1605,1605,0,"3"
2803906,"MALHADOR","NORDESTE","SERGIPE","101.8879239",11533,5182,5182,0,"2.8"
2804003,"MARUIM","NORDESTE","SERGIPE","95.5544193",15719,6355,6355,0,"3"
2804102,"MOITA BONITA","NORDESTE","SERGIPE","95.3965928",11050,5330,5327,3,"2.6"
2804201,"MONTE ALEGRE DE SERGIPE","NORDESTE","SERGIPE","386.9119169",14336,6345,6341,4,"3"
2804300,"MURIBECA","NORDESTE","SERGIPE","74.3101704",7822,3692,3690,2,"2.8"
2804409,"NEÓPOLIS","NORDESTE","SERGIPE","271.3231359",16426,7580,7570,10,"2.9"
2804458,"NOSSA SENHORA APARECIDA","NORDESTE","SERGIPE","340.7720382",9232,4611,4609,2,"2.7"
2804508,"NOSSA SENHORA DA GLÓRIA","NORDESTE","SERGIPE","758.4373124",41212,18337,18325,12,"2.9"
2804607,"NOSSA SENHORA DAS DORES","NORDESTE","SERGIPE","482.3668012",24996,12021,12015,6,"2.7"
2804706,"NOSSA SENHORA DE LOURDES","NORDESTE","SERGIPE","83.7667743",6268,2856,2854,2,"2.8"
2804805,"NOSSA SENHORA DO SOCORRO","NORDESTE","SERGIPE","155.0185697",192330,82833,82822,11,"2.9"
2804904,"PACATUBA","NORDESTE","SERGIPE","381.4278788",12502,6388,6379,9,"3"
2805000,"PEDRA MOLE","NORDESTE","SERGIPE","82.1836768",2778,1327,1327,0,"2.9"
2805109,"PEDRINHAS","NORDESTE","SERGIPE","33.3440654",7396,3608,3607,1,"2.8"
2805208,"PINHÃO","NORDESTE","SERGIPE","156.4004578",5677,2772,2772,0,"2.8"
2805307,"PIRAMBU","NORDESTE","SERGIPE","208.6811799",7913,4895,4889,6,"3"
2805406,"POÇO REDONDO","NORDESTE","SERGIPE","1220.4256426",33439,15114,15110,4,"3.1"
2805505,"POÇO VERDE","NORDESTE","SERGIPE","441.3262994",21794,11312,11308,4,"2.6"
2805604,"PORTO DA FOLHA","NORDESTE","SERGIPE","878.0428793",26576,14274,14265,9,"2.9"
2805703,"PROPRIÁ","NORDESTE","SERGIPE","96.3200629",26618,11845,11822,23,"2.9"
2805802,"RIACHÃO DO DANTAS","NORDESTE","SERGIPE","530.6068356",18313,8115,8115,0,"2.9"
2805901,"RIACHUELO","NORDESTE","SERGIPE","78.3078",8748,3464,3462,2,"3.1"
2806008,"RIBEIRÓPOLIS","NORDESTE","SERGIPE","259.0556677",17033,8861,8859,2,"2.6"
2806107,"ROSÁRIO DO CATETE","NORDESTE","SERGIPE","102.6834755",9295,4091,4088,3,"2.9"
2806206,"SALGADO","NORDESTE","SERGIPE","247.5791582",20279,10159,10155,4,"2.8"
2806305,"SANTA LUZIA DO ITANHY","NORDESTE","SERGIPE","325.2580921",13616,6084,6083,1,"3"
2806404,"SANTANA DO SÃO FRANCISCO","NORDESTE","SERGIPE","44.0172684",7346,2913,2912,1,"3.1"
2806503,"SANTA ROSA DE LIMA","NORDESTE","SERGIPE","67.6715954",3937,1819,1819,0,"2.9"
2806602,"SANTO AMARO DAS BROTAS","NORDESTE","SERGIPE","236.9652362",11092,5542,5538,4,"2.9"
2806701,"SÃO CRISTÓVÃO","NORDESTE","SERGIPE","438.0372448",95612,43652,43628,24,"2.8"
2806800,"SÃO DOMINGOS","NORDESTE","SERGIPE","101.9992652",10327,5279,5279,0,"2.7"
2806909,"SÃO FRANCISCO","NORDESTE","SERGIPE","83.9853458",3243,1642,1642,0,"2.8"
2807006,"SÃO MIGUEL DO ALEIXO","NORDESTE","SERGIPE","144.8680513",3434,1868,1868,0,"2.7"
2807105,"SIMÃO DIAS","NORDESTE","SERGIPE","560.199396",42578,19708,19693,15,"2.7"
2807204,"SIRIRI","NORDESTE","SERGIPE","168.3430272",7834,3584,3582,2,"2.9"
2807303,"TELHA","NORDESTE","SERGIPE","47.8597172",3274,1411,1411,0,"2.9"
2807402,"TOBIAS BARRETO","NORDESTE","SERGIPE","1024.6449215",50905,23721,23697,24,"2.7"
2807501,"TOMAR DO GERU","NORDESTE","SERGIPE","304.8374241",12012,5999,5996,3,"2.7"
2807600,"UMBAÚBA","NORDESTE","SERGIPE","117.513823",23917,10353,10346,7,"2.9"
2900108,"ABAÍRA","NORDESTE","BAHIA","538.6774538",7301,4290,4288,2,"2.7"
2900207,"ABARÉ","NORDESTE","BAHIA","1604.9230991",17639,7243,7240,3,"3.2"
2900306,"ACAJUTIBA","NORDESTE","BAHIA","181.4750875",13795,6405,6399,6,"2.9"
2900355,"ADUSTINA","NORDESTE","BAHIA","629.0986899",14201,6997,6993,4,"2.7"
2900405,"ÁGUA FRIA","NORDESTE","BAHIA","742.7751115",14497,8042,8037,5,"2.7"
2900504,"ÉRICO CARDOSO","NORDESTE","BAHIA","735.2491525",10604,4209,4206,3,"3.4"
2900603,"AIQUARA","NORDESTE","BAHIA","167.8767983",4447,2035,2035,0,"2.9"
2900702,"ALAGOINHAS","NORDESTE","BAHIA","707.8355107",151055,70414,70369,45,"2.7"
2900801,"ALCOBAÇA","NORDESTE","BAHIA","1477.929287",24530,13575,13532,43,"2.8"
2900900,"ALMADINA","NORDESTE","BAHIA","245.2360839",5218,2812,2809,3,"2.5"
2901007,"AMARGOSA","NORDESTE","BAHIA","431.6545955",36521,17293,17268,25,"2.7"
2901106,"AMÉLIA RODRIGUES","NORDESTE","BAHIA","166.8723817",24138,11024,11019,5,"2.8"
2901155,"AMÉRICA DOURADA","NORDESTE","BAHIA","822.3725491",15137,7229,7226,3,"2.9"
2901205,"ANAGÉ","NORDESTE","BAHIA","1899.683197",25438,12705,12698,7,"2.9"
2901304,"ANDARAÍ","NORDESTE","BAHIA","1590.3160921",13080,6624,6593,31,"2.9"
2901353,"ANDORINHA","NORDESTE","BAHIA","1362.3861578",15012,8482,8474,8,"2.5"
2901403,"ANGICAL","NORDESTE","BAHIA","1530.0504192",13732,6590,6587,3,"3"
2901502,"ANGUERA","NORDESTE","BAHIA","187.8399309",11031,4079,4075,4,"3.5"
2901601,"ANTAS","NORDESTE","BAHIA","319.7450773",14206,5545,5537,8,"3.2"
2901700,"ANTÔNIO CARDOSO","NORDESTE","BAHIA","293.5297362",11146,4708,4708,0,"3.2"
2901809,"ANTÔNIO GONÇALVES","NORDESTE","BAHIA","345.2836163",10862,4559,4557,2,"3.1"
2901908,"APORÁ","NORDESTE","BAHIA","479.2621714",15922,7731,7727,4,"2.8"
2901957,"APUAREMA","NORDESTE","BAHIA","150.8297566",6913,3312,3308,4,"2.8"
2902005,"ARACATU","NORDESTE","BAHIA","1489.8032094",13936,6719,6716,3,"3"
2902054,"ARAÇÁS","NORDESTE","BAHIA","474.5765328",11557,5515,5506,9,"2.8"
2902104,"ARACI","NORDESTE","BAHIA","1496.2454328",48294,24997,24992,5,"2.8"
2902203,"ARAMARI","NORDESTE","BAHIA","368.9470183",9833,4763,4762,1,"2.8"
2902252,"ARATACA","NORDESTE","BAHIA","435.9619137",10191,5129,5123,6,"2.9"
2902302,"ARATUÍPE","NORDESTE","BAHIA","174.0118097",8677,4098,4097,1,"2.8"
2902401,"AURELINO LEAL","NORDESTE","BAHIA","445.3937183",11179,6032,6030,2,"2.8"
2902500,"BAIANÓPOLIS","NORDESTE","BAHIA","3320.7227535",13614,6116,6109,7,"3.1"
2902609,"BAIXA GRANDE","NORDESTE","BAHIA","967.5136962",18220,9463,9458,5,"2.8"
2902658,"BANZAÊ","NORDESTE","BAHIA","409.5074489",11958,5199,5195,4,"3"
2902708,"BARRA","NORDESTE","BAHIA","11428.1116247",51092,21037,21019,18,"3.3"
2902807,"BARRA DA ESTIVA","NORDESTE","BAHIA","1657.4127267",26026,11407,11395,12,"3"
2902906,"BARRA DO CHOÇA","NORDESTE","BAHIA","765.9359945",36539,15695,15657,38,"3"
2903003,"BARRA DO MENDES","NORDESTE","BAHIA","1436.2987073",13836,7205,7203,2,"2.7"
2903102,"BARRA DO ROCHA","NORDESTE","BAHIA","214.4113557",5775,2604,2604,0,"2.7"
2903201,"BARREIRAS","NORDESTE","BAHIA","8051.2737877",159734,70200,70004,196,"2.9"
2903235,"BARRO ALTO","NORDESTE","BAHIA","414.5096503",13453,6830,6828,2,"2.8"
2903276,"BARROCAS","NORDESTE","BAHIA","207.2968919",15203,7033,7030,3,"2.9"
2903300,"BARRO PRETO","NORDESTE","BAHIA","201.5848711",5833,3358,3357,1,"2.6"
2903409,"BELMONTE","NORDESTE","BAHIA","1939.44699",20121,11330,11302,28,"2.8"
2903508,"BELO CAMPO","NORDESTE","BAHIA","772.7564859",18412,8091,8085,6,"2.9"
2903607,"BIRITINGA","NORDESTE","BAHIA","553.7623387",15146,7746,7746,0,"2.8"
2903706,"BOA NOVA","NORDESTE","BAHIA","848.8567926",13690,7025,7021,4,"2.9"
2903805,"BOA VISTA DO TUPIM","NORDESTE","BAHIA","2972.1092091",16873,10245,10239,6,"2.8"
2903904,"BOM JESUS DA LAPA","NORDESTE","BAHIA","4115.5103508",65550,27189,27037,152,"3.1"
2903953,"BOM JESUS DA SERRA","NORDESTE","BAHIA","467.9091017",9730,4205,4202,3,"3.1"
2904001,"BONINAL","NORDESTE","BAHIA","896.8573367",13622,6201,6196,5,"3.1"
2904050,"BONITO","NORDESTE","BAHIA","791.2755619",15844,8249,8239,10,"2.9"
2904100,"BOQUIRA","NORDESTE","BAHIA","1426.2331891",19322,9890,9890,0,"3"
2904209,"BOTUPORÃ","NORDESTE","BAHIA","627.6124912",11024,4715,4713,2,"3"
2904308,"BREJÕES","NORDESTE","BAHIA","518.5663258",12943,6874,6861,13,"2.7"
2904407,"BREJOLÂNDIA","NORDESTE","BAHIA","2247.2082288",9108,4518,4511,7,"2.9"
2904506,"BROTAS DE MACAÚBAS","NORDESTE","BAHIA","2520.8165277",11765,6560,6551,9,"2.8"
2904605,"BRUMADO","NORDESTE","BAHIA","2207.6117118",70510,31423,31404,19,"2.9"
2904704,"BUERAREMA","NORDESTE","BAHIA","219.4870809",14804,7477,7473,4,"2.6"
2904753,"BURITIRAMA","NORDESTE","BAHIA","4046.7359955",19589,7868,7860,8,"3.3"
2904803,"CAATIBA","NORDESTE","BAHIA","512.4355747",6205,2908,2901,7,"2.8"
2904852,"CABACEIRAS DO PARAGUAÇU","NORDESTE","BAHIA","222.026531",16559,6893,6891,2,"3.2"
2904902,"CACHOEIRA","NORDESTE","BAHIA","394.893666",29250,15587,15555,32,"2.7"
2905008,"CACULÉ","NORDESTE","BAHIA","610.9826416",22462,10614,10606,8,"2.9"
2905107,"CAÉM","NORDESTE","BAHIA","540.9080575",10384,5094,5093,1,"2.9"
2905156,"CAETANOS","NORDESTE","BAHIA","767.1456791",11266,4814,4807,7,"3.1"
2905206,"CAETITÉ","NORDESTE","BAHIA","2651.5357847",52012,24459,24432,27,"2.9"
2905305,"CAFARNAUM","NORDESTE","BAHIA","643.6599305",17466,8133,8131,2,"3"
2905404,"CAIRU","NORDESTE","BAHIA","448.8459209",17761,10442,10292,150,"2.7"
2905503,"CALDEIRÃO GRANDE","NORDESTE","BAHIA","458.311001",13080,6124,6121,3,"3"
2905602,"CAMACAN","NORDESTE","BAHIA","584.84768",22579,11746,11735,11,"2.7"
2905701,"CAMAÇARI","NORDESTE","BAHIA","785.4210336",300372,177233,177140,93,"2.7"
2905800,"CAMAMU","NORDESTE","BAHIA","839.7016294",30469,15567,15547,20,"2.9"
2905909,"CAMPO ALEGRE DE LOURDES","NORDESTE","BAHIA","2914.5745218",30671,14585,14566,19,"3"
2906006,"CAMPO FORMOSO","NORDESTE","BAHIA","7161.8267361",71377,34437,34408,29,"2.9"
2906105,"CANÁPOLIS","NORDESTE","BAHIA","460.3880454",10225,4578,4577,1,"3.1"
2906204,"CANARANA","NORDESTE","BAHIA","579.7261457",24206,11409,11404,5,"2.9"
2906303,"CANAVIEIRAS","NORDESTE","BAHIA","1334.2843831",32683,17067,17034,33,"2.7"
2906402,"CANDEAL","NORDESTE","BAHIA","447.5775837",7772,4060,4059,1,"2.8"
2906501,"CANDEIAS","NORDESTE","BAHIA","251.807833",72382,37141,37132,9,"2.7"
2906600,"CANDIBA","NORDESTE","BAHIA","433.6422701",13016,6628,6628,0,"2.9"
2906709,"CÂNDIDO SALES","NORDESTE","BAHIA","1169.8137479",25247,11687,11675,12,"2.8"
2906808,"CANSANÇÃO","NORDESTE","BAHIA","1351.891078",37439,16504,16495,9,"2.9"
2906824,"CANUDOS","NORDESTE","BAHIA","3565.3770896",16105,7635,7628,7,"3"
2906857,"CAPELA DO ALTO ALEGRE","NORDESTE","BAHIA","629.5862981",10744,6487,6487,0,"2.5"
2906873,"CAPIM GROSSO","NORDESTE","BAHIA","464.7761437",33235,16807,16799,8,"2.7"
2906899,"CARAÍBAS","NORDESTE","BAHIA","805.6290388",9940,5018,5014,4,"2.9"
2906907,"CARAVELAS","NORDESTE","BAHIA","2377.8892467",20580,10161,10138,23,"2.8"
2907004,"CARDEAL DA SILVA","NORDESTE","BAHIA","293.4559267",8365,3936,3931,5,"3"
2907103,"CARINHANHA","NORDESTE","BAHIA","2525.905906",28869,13945,13935,10,"3.1"
2907202,"CASA NOVA","NORDESTE","BAHIA","9647.0718077",72086,29593,29586,7,"3.1"
2907301,"CASTRO ALVES","NORDESTE","BAHIA","713.7886619",24712,11168,11157,11,"2.8"
2907400,"CATOLÂNDIA","NORDESTE","BAHIA","702.5040757",3434,1608,1607,1,"3.1"
2907509,"CATU","NORDESTE","BAHIA","426.9548397",48148,23225,23211,14,"2.6"
2907558,"CATURAMA","NORDESTE","BAHIA","716.2613665",8841,4486,4483,3,"2.9"
2907608,"CENTRAL","NORDESTE","BAHIA","566.9738115",16348,7861,7856,5,"2.8"
2907707,"CHORROCHÓ","NORDESTE","BAHIA","3005.3192363",10579,4587,4577,10,"3.3"
2907806,"CÍCERO DANTAS","NORDESTE","BAHIA","819.969392",30907,15922,15911,11,"2.6"
2907905,"CIPÓ","NORDESTE","BAHIA","168.3300619",17230,7585,7577,8,"3"
2908002,"COARACI","NORDESTE","BAHIA","274.500403",17333,9192,9190,2,"2.6"
2908101,"COCOS","NORDESTE","BAHIA","10140.5717604",19151,9297,9268,29,"3"
2908200,"CONCEIÇÃO DA FEIRA","NORDESTE","BAHIA","164.7982401",20800,8848,8846,2,"3"
2908309,"CONCEIÇÃO DO ALMEIDA","NORDESTE","BAHIA","284.8363389",15794,7168,7164,4,"2.7"
2908408,"CONCEIÇÃO DO COITÉ","NORDESTE","BAHIA","1015.2511873",67825,33508,33493,15,"2.8"
2908507,"CONCEIÇÃO DO JACUÍPE","NORDESTE","BAHIA","114.8689542",35308,15802,15796,6,"2.8"
2908606,"CONDE","NORDESTE","BAHIA","931.1062678",23654,12747,12725,22,"3.1"
2908705,"CONDEÚBA","NORDESTE","BAHIA","1348.0394997",17053,8124,8117,7,"2.9"
2908804,"CONTENDAS DO SINCORÁ","NORDESTE","BAHIA","977.4554676",4333,2186,2185,1,"2.9"
2908903,"CORAÇÃO DE MARIA","NORDESTE","BAHIA","378.4204842",26692,12536,12528,8,"3"
2909000,"CORDEIROS","NORDESTE","BAHIA","523.6400014",7546,3492,3491,1,"2.9"
2909109,"CORIBE","NORDESTE","BAHIA","2662.8189366",13990,7437,7435,2,"2.8"
2909208,"CORONEL JOÃO SÁ","NORDESTE","BAHIA","797.4338211",17056,8118,8116,2,"2.8"
2909307,"CORRENTINA","NORDESTE","BAHIA","11504.3143347",32457,15964,15827,137,"2.9"
2909406,"COTEGIPE","NORDESTE","BAHIA","4282.7747023",13063,6675,6667,8,"3"
2909505,"CRAVOLÂNDIA","NORDESTE","BAHIA","182.5851475",4415,2333,2333,0,"2.7"
2909604,"CRISÓPOLIS","NORDESTE","BAHIA","636.608756",19729,10228,10222,6,"2.7"
2909703,"CRISTÓPOLIS","NORDESTE","BAHIA","1052.8370613",13993,6155,6151,4,"3"
2909802,"CRUZ DAS ALMAS","NORDESTE","BAHIA","139.1174051",60348,28010,27991,19,"2.8"
2909901,"CURAÇÁ","NORDESTE","BAHIA","5950.6137309",34180,14943,14934,9,"3"
2910008,"DÁRIO MEIRA","NORDESTE","BAHIA","413.6371807",10820,5163,5159,4,"2.8"
2910057,"DIAS D'ÁVILA","NORDESTE","BAHIA","183.7590975",71485,36003,35977,26,"2.8"
2910107,"DOM BASÍLIO","NORDESTE","BAHIA","689.5158147",11884,4522,4519,3,"3.1"
2910206,"DOM MACEDO COSTA","NORDESTE","BAHIA","94.7775709",4407,2153,2150,3,"2.7"
2910305,"ELÍSIO MEDRADO","NORDESTE","BAHIA","179.3291297",7808,4118,4115,3,"2.6"
2910404,"ENCRUZILHADA","NORDESTE","BAHIA","1890.1326538",19107,9789,9773,16,"2.8"
2910503,"ENTRE RIOS","NORDESTE","BAHIA","1187.7659658",38098,23385,23285,100,"2.8"
2910602,"ESPLANADA","NORDESTE","BAHIA","1299.3551563",32554,14938,14921,17,"3"
2910701,"EUCLIDES DA CUNHA","NORDESTE","BAHIA","2025.3675346",61456,27943,27920,23,"2.8"
2910727,"EUNÁPOLIS","NORDESTE","BAHIA","1425.9699516",113710,51024,50963,61,"2.7"
2910750,"FÁTIMA","NORDESTE","BAHIA","364.4188152",17895,9175,9173,2,"2.6"
2910776,"FEIRA DA MATA","NORDESTE","BAHIA","1176.1112506",5631,3163,3158,5,"2.8"
2910800,"FEIRA DE SANTANA","NORDESTE","BAHIA","1304.424933",616272,288378,288237,141,"2.8"
2910859,"FILADÉLFIA","NORDESTE","BAHIA","579.6855051",17897,8134,8134,0,"2.9"
2910909,"FIRMINO ALVES","NORDESTE","BAHIA","172.3526307",4873,2459,2458,1,"2.7"
2911006,"FLORESTA AZUL","NORDESTE","BAHIA","321.01279",11059,4875,4874,1,"2.9"
2911105,"FORMOSA DO RIO PRETO","NORDESTE","BAHIA","15634.3276576",25899,11392,11153,239,"3.2"
2911204,"GANDU","NORDESTE","BAHIA","229.6612573",32178,13844,13830,14,"2.7"
2911253,"GAVIÃO","NORDESTE","BAHIA","384.5921148",4360,2454,2452,2,"2.6"
2911303,"GENTIO DO OURO","NORDESTE","BAHIA","3817.9463585",10884,5417,5414,3,"3"
2911402,"GLÓRIA","NORDESTE","BAHIA","1566.6092415",15524,7574,7569,5,"2.9"
2911501,"GONGOGI","NORDESTE","BAHIA","202.1939731",5555,2845,2843,2,"2.8"
2911600,"GOVERNADOR MANGABEIRA","NORDESTE","BAHIA","106.8479017",20605,9180,9173,7,"2.9"
2911659,"GUAJERU","NORDESTE","BAHIA","872.8671471",8050,3687,3687,0,"2.9"
2911709,"GUANAMBI","NORDESTE","BAHIA","1272.3664304",87817,40669,40626,43,"2.9"
2911808,"GUARATINGA","NORDESTE","BAHIA","2189.4036075",19049,10775,10762,13,"2.6"
2911857,"HELIÓPOLIS","NORDESTE","BAHIA","313.4377292",12309,6207,6207,0,"2.7"
2911907,"IAÇU","NORDESTE","BAHIA","2342.4967468",24607,13485,13472,13,"2.7"
2912004,"IBIASSUCÊ","NORDESTE","BAHIA","483.2737075",10429,4884,4881,3,"3"
2912103,"IBICARAÍ","NORDESTE","BAHIA","230.953116",21665,10769,10763,6,"2.6"
2912202,"IBICOARA","NORDESTE","BAHIA","817.3550384",20785,8699,8679,20,"3"
2912301,"IBICUÍ","NORDESTE","BAHIA","1139.3782769",13934,7225,7212,13,"2.6"
2912400,"IBIPEBA","NORDESTE","BAHIA","1382.0075078",16603,8404,8399,5,"2.8"
2912509,"IBIPITANGA","NORDESTE","BAHIA","954.3726023",13863,6915,6911,4,"2.9"
2912608,"IBIQUERA","NORDESTE","BAHIA","698.2446917",3725,2030,2027,3,"2.9"
2912707,"IBIRAPITANGA","NORDESTE","BAHIA","472.6636631",25344,10369,10362,7,"3"
2912806,"IBIRAPUÃ","NORDESTE","BAHIA","771.0975759",8896,4317,4313,4,"2.8"
2912905,"IBIRATAIA","NORDESTE","BAHIA","318.1294303",18792,8957,8956,1,"2.7"
2913002,"IBITIARA","NORDESTE","BAHIA","1834.0023891",14637,7332,7324,8,"2.9"
2913101,"IBITITÁ","NORDESTE","BAHIA","573.0334455",16969,7974,7973,1,"2.8"
2913200,"IBOTIRAMA","NORDESTE","BAHIA","1740.1129104",26309,12207,12187,20,"2.9"
2913309,"ICHU","NORDESTE","BAHIA","138.0161916",6190,3020,3017,3,"2.8"
2913408,"IGAPORÃ","NORDESTE","BAHIA","836.5857141",15527,6495,6494,1,"3.2"
2913457,"IGRAPIÚNA","NORDESTE","BAHIA","591.3121061",13151,6573,6563,10,"2.9"
2913507,"IGUAÍ","NORDESTE","BAHIA","860.2234683",21491,10577,10567,10,"2.7"
2913606,"ILHÉUS","NORDESTE","BAHIA","1588.5548182",178649,96056,95939,117,"2.7"
2913705,"INHAMBUPE","NORDESTE","BAHIA","1082.2827591",33790,16734,16720,14,"2.8"
2913804,"IPECAETÁ","NORDESTE","BAHIA","372.5649204",13709,5693,5690,3,"3.3"
2913903,"IPIAÚ","NORDESTE","BAHIA","280.453523",40706,18780,18750,30,"2.7"
2914000,"IPIRÁ","NORDESTE","BAHIA","3105.280423",56876,29457,29439,18,"2.7"
2914109,"IPUPIARA","NORDESTE","BAHIA","1055.7600677",9935,5061,5057,4,"2.8"
2914208,"IRAJUBA","NORDESTE","BAHIA","459.0467718",6101,3284,3280,4,"2.8"
2914307,"IRAMAIA","NORDESTE","BAHIA","1708.1148796",10752,5193,5185,8,"2.9"
2914406,"IRAQUARA","NORDESTE","BAHIA","991.8222614",23879,11717,11711,6,"2.9"
2914505,"IRARÁ","NORDESTE","BAHIA","267.8798688",28043,13655,13649,6,"2.8"
2914604,"IRECÊ","NORDESTE","BAHIA","319.1744134",74507,31512,31486,26,"2.9"
2914653,"ITABELA","NORDESTE","BAHIA","924.9144992",28165,12598,12583,15,"2.9"
2914703,"ITABERABA","NORDESTE","BAHIA","2386.3898394",65073,31126,31092,34,"2.8"
2914802,"ITABUNA","NORDESTE","BAHIA","401.0284707",186708,93345,93295,50,"2.6"
2914901,"ITACARÉ","NORDESTE","BAHIA","726.2654801",27704,14513,14401,112,"2.8"
2915007,"ITAETÉ","NORDESTE","BAHIA","1331.8223842",13472,7061,7050,11,"3"
2915106,"ITAGI","NORDESTE","BAHIA","310.6210324",13803,6001,6000,1,"3"
2915205,"ITAGIBÁ","NORDESTE","BAHIA","810.9935067",15310,7185,7177,8,"2.8"
2915304,"ITAGIMIRIM","NORDESTE","BAHIA","876.8001896",6347,3253,3245,8,"2.7"
2915353,"ITAGUAÇU DA BAHIA","NORDESTE","BAHIA","4310.2380176",12311,6372,6363,9,"3"
2915403,"ITAJU DO COLÔNIA","NORDESTE","BAHIA","1225.2867689",6037,3148,3146,2,"2.9"
2915502,"ITAJUÍPE","NORDESTE","BAHIA","270.7521544",18781,9480,9478,2,"2.7"
2915601,"ITAMARAJU","NORDESTE","BAHIA","2360.584449",59605,28348,28333,15,"2.7"
2915700,"ITAMARI","NORDESTE","BAHIA","143.4791909",7051,3617,3615,2,"2.8"
2915809,"ITAMBÉ","NORDESTE","BAHIA","1534.5751978",24394,9965,9957,8,"3"
2915908,"ITANAGRA","NORDESTE","BAHIA","533.6338274",5914,3575,3564,11,"2.9"
2916005,"ITANHÉM","NORDESTE","BAHIA","1394.1743922",17813,9062,9051,11,"2.6"
2916104,"ITAPARICA","NORDESTE","BAHIA","121.3727714",19789,16090,16072,18,"2.7"
2916203,"ITAPÉ","NORDESTE","BAHIA","453.1441351",10341,4892,4889,3,"2.8"
2916302,"ITAPEBI","NORDESTE","BAHIA","1013.0738685",9174,4721,4706,15,"2.8"
2916401,"ITAPETINGA","NORDESTE","BAHIA","1651.1575904",65897,28998,28982,16,"2.7"
2916500,"ITAPICURU","NORDESTE","BAHIA","1557.6853673",31679,16785,16784,1,"2.8"
2916609,"ITAPITANGA","NORDESTE","BAHIA","420.6634074",10279,3759,3758,1,"3.4"
2916708,"ITAQUARA","NORDESTE","BAHIA","344.0932841",8153,3651,3649,2,"2.9"
2916807,"ITARANTIM","NORDESTE","BAHIA","1674.0291091",17052,7776,7767,9,"2.7"
2916856,"ITATIM","NORDESTE","BAHIA","547.5102084",15737,7066,7059,7,"2.8"
2916906,"ITIRUÇU","NORDESTE","BAHIA","322.2429622",10999,5148,5144,4,"2.8"
2917003,"ITIÚBA","NORDESTE","BAHIA","1650.5929752",33872,16652,16645,7,"2.8"
2917102,"ITORORÓ","NORDESTE","BAHIA","313.8393853",16617,8387,8383,4,"2.7"
2917201,"ITUAÇU","NORDESTE","BAHIA","1199.3743504",17914,8692,8650,42,"2.9"
2917300,"ITUBERÁ","NORDESTE","BAHIA","415.4276802",21902,11856,11826,30,"2.7"
2917334,"IUIU","NORDESTE","BAHIA","1525.1421899",11118,4668,4663,5,"3.2"
2917359,"JABORANDI","NORDESTE","BAHIA","9955.1128239",9275,5096,5084,12,"2.8"
2917409,"JACARACI","NORDESTE","BAHIA","1332.4200396",14436,6683,6682,1,"3.2"
2917508,"JACOBINA","NORDESTE","BAHIA","2192.9054117",82590,42748,42709,39,"2.7"
2917607,"JAGUAQUARA","NORDESTE","BAHIA","924.5122069",45964,20911,20895,16,"2.9"
2917706,"JAGUARARI","NORDESTE","BAHIA","2466.0092513",32703,15943,15931,12,"2.8"
2917805,"JAGUARIPE","NORDESTE","BAHIA","863.424068",17659,9800,9770,30,"2.8"
2917904,"JANDAÍRA","NORDESTE","BAHIA","640.7723382",9285,4597,4582,15,"3"
2918001,"JEQUIÉ","NORDESTE","BAHIA","2969.0387342",158813,73601,73555,46,"2.7"
2918100,"JEREMOABO","NORDESTE","BAHIA","4267.4879515",37626,18397,18372,25,"2.8"
2918209,"JIQUIRIÇÁ","NORDESTE","BAHIA","238.6600317",13629,6051,6049,2,"2.8"
2918308,"JITAÚNA","NORDESTE","BAHIA","262.0502259",14355,6856,6854,2,"2.8"
2918357,"JOÃO DOURADO","NORDESTE","BAHIA","913.2577012",24854,10401,10400,1,"3"
2918407,"JUAZEIRO","NORDESTE","BAHIA","6721.236766",237821,101721,101638,83,"3"
2918456,"JUCURUÇU","NORDESTE","BAHIA","1457.6556999",9655,5263,5263,0,"2.8"
2918506,"JUSSARA","NORDESTE","BAHIA","1355.1731706",16354,7974,7972,2,"2.9"
2918555,"JUSSARI","NORDESTE","BAHIA","329.1903017",5888,2955,2955,0,"2.8"
2918605,"JUSSIAPE","NORDESTE","BAHIA","589.7627629",7379,3561,3558,3,"2.9"
2918704,"LAFAIETE COUTINHO","NORDESTE","BAHIA","498.1098321",4075,2452,2452,0,"2.5"
2918753,"LAGOA REAL","NORDESTE","BAHIA","912.2223589",14105,5452,5451,1,"3.2"
2918803,"LAJE","NORDESTE","BAHIA","449.8343678",21052,10289,10283,6,"2.8"
2918902,"LAJEDÃO","NORDESTE","BAHIA","624.3530196",3845,2078,2077,1,"2.6"
2919009,"LAJEDINHO","NORDESTE","BAHIA","846.7279757",3527,2201,2200,1,"2.8"
2919058,"LAJEDO DO TABOCAL","NORDESTE","BAHIA","382.9364706",7494,3531,3530,1,"2.7"
2919108,"LAMARÃO","NORDESTE","BAHIA","189.2591832",9015,4433,4432,1,"2.9"
2919157,"LAPÃO","NORDESTE","BAHIA","642.882194",25736,11076,11074,2,"2.9"
2919207,"LAURO DE FREITAS","NORDESTE","BAHIA","57.9424945",203331,95739,95701,38,"2.7"
2919306,"LENÇÓIS","NORDESTE","BAHIA","1283.3279203",10774,5920,5850,70,"2.7"
2919405,"LICÍNIO DE ALMEIDA","NORDESTE","BAHIA","856.6260023",11834,5553,5550,3,"2.9"
2919504,"LIVRAMENTO DE NOSSA SENHORA","NORDESTE","BAHIA","1952.5099343",43903,18697,18687,10,"3"
2919553,"LUÍS EDUARDO MAGALHÃES","NORDESTE","BAHIA","4036.0936423",107909,44743,44629,114,"3"
2919603,"MACAJUBA","NORDESTE","BAHIA","701.1709946",10454,5663,5657,6,"2.7"
2919702,"MACARANI","NORDESTE","BAHIA","1210.1064517",21599,7954,7950,4,"3"
2919801,"MACAÚBAS","NORDESTE","BAHIA","2459.1018887",41859,20045,20029,16,"3"
2919900,"MACURURÉ","NORDESTE","BAHIA","2545.8563915",7256,3788,3782,6,"3"
2919926,"MADRE DE DEUS","NORDESTE","BAHIA","32.2006439",18504,10009,10001,8,"2.7"
2919959,"MAETINGA","NORDESTE","BAHIA","614.8335445",6973,3663,3661,2,"2.9"
2920007,"MAIQUINIQUE","NORDESTE","BAHIA","588.2971108",8731,4156,4148,8,"2.8"
2920106,"MAIRI","NORDESTE","BAHIA","906.680177",17674,8770,8767,3,"2.8"
2920205,"MALHADA","NORDESTE","BAHIA","1979.1929233",15398,6815,6812,3,"3.2"
2920304,"MALHADA DE PEDRAS","NORDESTE","BAHIA","550.5501519",8670,3848,3847,1,"2.9"
2920403,"MANOEL VITORINO","NORDESTE","BAHIA","2201.7637868",13860,7066,7057,9,"2.9"
2920452,"MANSIDÃO","NORDESTE","BAHIA","3129.5876887",13919,4865,4860,5,"3.9"
2920502,"MARACÁS","NORDESTE","BAHIA","2413.2703479",27620,12795,12775,20,"2.8"
2920601,"MARAGOGIPE","NORDESTE","BAHIA","437.6103956",35859,17276,17246,30,"2.8"
2920700,"MARAÚ","NORDESTE","BAHIA","848.8849203",24527,14373,14284,89,"2.8"
2920809,"MARCIONÍLIO SOUZA","NORDESTE","BAHIA","1099.2833648",9267,4844,4841,3,"2.9"
2920908,"MASCOTE","NORDESTE","BAHIA","742.688675",13544,5979,5975,4,"2.8"
2921005,"MATA DE SÃO JOÃO","NORDESTE","BAHIA","605.1678424",42566,29302,29229,73,"2.8"
2921054,"MATINA","NORDESTE","BAHIA","773.2796554",10330,4793,4791,2,"3.2"
2921104,"MEDEIROS NETO","NORDESTE","BAHIA","1311.739255",22194,10816,10808,8,"2.6"
2921203,"MIGUEL CALMON","NORDESTE","BAHIA","1599.6716404",24661,14226,14219,7,"2.6"
2921302,"MILAGRES","NORDESTE","BAHIA","420.357458",11071,5349,5341,8,"2.8"
2921401,"MIRANGABA","NORDESTE","BAHIA","1751.7781068",15734,8034,8033,1,"2.8"
2921450,"MIRANTE","NORDESTE","BAHIA","1172.8605161",10187,4776,4774,2,"3"
2921500,"MONTE SANTO","NORDESTE","BAHIA","3034.1968775",47780,24887,24877,10,"2.8"
2921609,"MORPARÁ","NORDESTE","BAHIA","2093.8722839",7996,4071,4064,7,"2.9"
2921708,"MORRO DO CHAPÉU","NORDESTE","BAHIA","5744.9691427",33594,18502,18481,21,"2.8"
2921807,"MORTUGABA","NORDESTE","BAHIA","528.214469",11143,5461,5458,3,"2.9"
2921906,"MUCUGÊ","NORDESTE","BAHIA","2462.1531889",12137,6165,6107,58,"2.9"
2922003,"MUCURI","NORDESTE","BAHIA","1787.6261976",37977,19098,19056,42,"2.8"
2922052,"MULUNGU DO MORRO","NORDESTE","BAHIA","646.620708",13152,6636,6636,0,"2.9"
2922102,"MUNDO NOVO","NORDESTE","BAHIA","1491.9902772",17305,9707,9700,7,"2.7"
2922201,"MUNIZ FERREIRA","NORDESTE","BAHIA","104.5398668",7190,3564,3562,2,"2.6"
2922250,"MUQUÉM DO SÃO FRANCISCO","NORDESTE","BAHIA","3852.1110313",10443,4908,4905,3,"3.1"
2922300,"MURITIBA","NORDESTE","BAHIA","86.311535",28707,12669,12663,6,"2.9"
2922409,"MUTUÍPE","NORDESTE","BAHIA","275.8542035",20037,9935,9930,5,"2.7"
2922508,"NAZARÉ","NORDESTE","BAHIA","278.6294708",27060,12532,12524,8,"2.7"
2922607,"NILO PEÇANHA","NORDESTE","BAHIA","388.9360403",12063,6115,6098,17,"2.8"
2922656,"NORDESTINA","NORDESTE","BAHIA","465.4069181",18523,6772,6766,6,"3.2"
2922706,"NOVA CANAÃ","NORDESTE","BAHIA","804.6173235",13715,6690,6684,6,"2.7"
2922730,"NOVA FÁTIMA","NORDESTE","BAHIA","346.783726",7967,4356,4349,7,"2.6"
2922755,"NOVA IBIÁ","NORDESTE","BAHIA","203.1983497",6501,3312,3312,0,"2.7"
2922805,"NOVA ITARANA","NORDESTE","BAHIA","475.3807499",7780,3834,3829,5,"2.9"
2922854,"NOVA REDENÇÃO","NORDESTE","BAHIA","565.3556362",7538,3951,3947,4,"2.8"
2922904,"NOVA SOURE","NORDESTE","BAHIA","966.9926186",24236,11993,11982,11,"2.8"
2923001,"NOVA VIÇOSA","NORDESTE","BAHIA","1316.3792899",39509,21766,21721,45,"2.9"
2923035,"NOVO HORIZONTE","NORDESTE","BAHIA","627.4996183",11162,5308,5302,6,"2.9"
2923050,"NOVO TRIUNFO","NORDESTE","BAHIA","278.4874552",10660,4021,4018,3,"3.3"
2923100,"OLINDINA","NORDESTE","BAHIA","637.3165994",22633,11237,11235,2,"2.7"
2923209,"OLIVEIRA DOS BREJINHOS","NORDESTE","BAHIA","3313.4176405",20715,10991,10978,13,"2.7"
2923308,"OURIÇANGAS","NORDESTE","BAHIA","156.9819813",7716,3772,3767,5,"2.8"
2923357,"OUROLÂNDIA","NORDESTE","BAHIA","1544.9882707",19243,9281,9271,10,"3.2"
2923407,"PALMAS DE MONTE ALTO","NORDESTE","BAHIA","2560.0267714",20078,10286,10286,0,"3"
2923506,"PALMEIRAS","NORDESTE","BAHIA","737.453977",10339,5813,5714,99,"2.9"
2923605,"PARAMIRIM","NORDESTE","BAHIA","1087.0605121",20351,8673,8662,11,"3"
2923704,"PARATINGA","NORDESTE","BAHIA","2624.998059",29252,11843,11839,4,"3.2"
2923803,"PARIPIRANGA","NORDESTE","BAHIA","442.18627",26604,13115,13110,5,"2.8"
2923902,"PAU BRASIL","NORDESTE","BAHIA","626.306243",9370,4653,4652,1,"2.8"
2924009,"PAULO AFONSO","NORDESTE","BAHIA","1544.3881066",112870,49975,49940,35,"2.9"
2924058,"PÉ DE SERRA","NORDESTE","BAHIA","596.7706943",13243,7004,6998,6,"2.7"
2924108,"PEDRÃO","NORDESTE","BAHIA","158.4875913",6235,2926,2926,0,"3"
2924207,"PEDRO ALEXANDRE","NORDESTE","BAHIA","889.57211",13954,5913,5912,1,"2.9"
2924306,"PIATÃ","NORDESTE","BAHIA","1825.8564662",20086,9541,9529,12,"3.1"
2924405,"PILÃO ARCADO","NORDESTE","BAHIA","11597.9356218",35357,15536,15530,6,"3.3"
2924504,"PINDAÍ","NORDESTE","BAHIA","628.4686289",14731,6750,6746,4,"2.9"
2924603,"PINDOBAÇU","NORDESTE","BAHIA","495.8445466",19083,9219,9210,9,"2.8"
2924652,"PINTADAS","NORDESTE","BAHIA","647.1437817",10325,4941,4938,3,"2.9"
2924678,"PIRAÍ DO NORTE","NORDESTE","BAHIA","193.4273884",10974,4239,4233,6,"3.4"
2924702,"PIRIPÁ","NORDESTE","BAHIA","511.7555781",9152,4744,4739,5,"2.8"
2924801,"PIRITIBA","NORDESTE","BAHIA","980.3277502",17566,9874,9869,5,"2.7"
2924900,"PLANALTINO","NORDESTE","BAHIA","955.4541894",8022,4068,4062,6,"2.7"
2925006,"PLANALTO","NORDESTE","BAHIA","769.0001322",23334,11207,11190,17,"2.8"
2925105,"POÇÕES","NORDESTE","BAHIA","937.85468",48293,21770,21749,21,"2.9"
2925204,"POJUCA","NORDESTE","BAHIA","314.9324801",32136,16239,16229,10,"2.7"
2925253,"PONTO NOVO","NORDESTE","BAHIA","530.1442264",17938,8643,8636,7,"2.8"
2925303,"PORTO SEGURO","NORDESTE","BAHIA","2285.7340377",168326,83218,82596,622,"2.8"
2925402,"POTIRAGUÁ","NORDESTE","BAHIA","1111.5673581",10274,4038,4037,1,"3.1"
2925501,"PRADO","NORDESTE","BAHIA","1692.1004346",35003,18800,18691,109,"3"
2925600,"PRESIDENTE DUTRA","NORDESTE","BAHIA","232.0635865",15130,6636,6633,3,"2.8"
2925709,"PRESIDENTE JÂNIO QUADROS","NORDESTE","BAHIA","1208.5488701",12621,6231,6227,4,"2.8"
2925758,"PRESIDENTE TANCREDO NEVES","NORDESTE","BAHIA","441.8195293",27734,12751,12742,9,"2.9"
2925808,"QUEIMADAS","NORDESTE","BAHIA","2011.059645",25988,12090,12083,7,"2.9"
2925907,"QUIJINGUE","NORDESTE","BAHIA","1380.7978938",25272,12293,12290,3,"2.9"
2925931,"QUIXABEIRA","NORDESTE","BAHIA","366.3866044",9461,5886,5885,1,"2.6"
2925956,"RAFAEL JAMBEIRO","NORDESTE","BAHIA","1090.5519215",19662,9562,9555,7,"3"
2926004,"REMANSO","NORDESTE","BAHIA","4573.5047032",40586,18049,18040,9,"3"
2926103,"RETIROLÂNDIA","NORDESTE","BAHIA","242.3294257",13651,6593,6591,2,"2.7"
2926202,"RIACHÃO DAS NEVES","NORDESTE","BAHIA","5977.9308552",21642,10422,10349,73,"3"
2926301,"RIACHÃO DO JACUÍPE","NORDESTE","BAHIA","1155.4186414",33386,16899,16881,18,"2.7"
2926400,"RIACHO DE SANTANA","NORDESTE","BAHIA","3183.9089647",30711,13888,13879,9,"3"
2926509,"RIBEIRA DO AMPARO","NORDESTE","BAHIA","644.2296922",13841,6864,6862,2,"2.9"
2926608,"RIBEIRA DO POMBAL","NORDESTE","BAHIA","1252.1437817",54010,26427,26402,25,"2.8"
2926657,"RIBEIRÃO DO LARGO","NORDESTE","BAHIA","1363.6996583",9740,5232,5231,1,"2.9"
2926707,"RIO DE CONTAS","NORDESTE","BAHIA","1115.251729",13184,6176,6160,16,"2.9"
2926806,"RIO DO ANTÔNIO","NORDESTE","BAHIA","777.9035067",13146,6576,6573,3,"2.9"
2926905,"RIO DO PIRES","NORDESTE","BAHIA","656.2230777",10497,4700,4697,3,"3"
2927002,"RIO REAL","NORDESTE","BAHIA","739.775497",35362,17068,17051,17,"2.8"
2927101,"RODELAS","NORDESTE","BAHIA","2207.1590972",10308,4319,4313,6,"3.2"
2927200,"RUY BARBOSA","NORDESTE","BAHIA","1991.771893",28282,14250,14233,17,"2.8"
2927309,"SALINAS DA MARGARIDA","NORDESTE","BAHIA","150.5694168",14987,9063,9052,11,"2.8"
2927408,"SALVADOR","NORDESTE","BAHIA","693.4420551",2417678,1212383,1211707,676,"2.5"
2927507,"SANTA BÁRBARA","NORDESTE","BAHIA","347.0210358",20952,10078,10068,10,"2.9"
2927606,"SANTA BRÍGIDA","NORDESTE","BAHIA","934.4607124",14965,7680,7674,6,"2.8"
2927705,"SANTA CRUZ CABRÁLIA","NORDESTE","BAHIA","1462.9416571",29185,16666,16613,53,"2.7"
2927804,"SANTA CRUZ DA VITÓRIA","NORDESTE","BAHIA","284.0826101",4681,2280,2278,2,"2.7"
2927903,"SANTA INÊS","NORDESTE","BAHIA","379.2696946",10300,4840,4832,8,"2.8"
2928000,"SANTALUZ","NORDESTE","BAHIA","1623.4452799",37834,17305,17295,10,"2.8"
2928059,"SANTA LUZIA","NORDESTE","BAHIA","824.4729137",13896,6360,6356,4,"2.9"
2928109,"SANTA MARIA DA VITÓRIA","NORDESTE","BAHIA","1984.9103773",38604,17304,17285,19,"2.9"
2928208,"SANTANA","NORDESTE","BAHIA","1909.3528053",24755,11815,11792,23,"2.9"
2928307,"SANTANÓPOLIS","NORDESTE","BAHIA","222.685552",8716,4413,4412,1,"2.9"
2928406,"SANTA RITA DE CÁSSIA","NORDESTE","BAHIA","6030.4913554",27390,14115,14099,16,"3"
2928505,"SANTA TEREZINHA","NORDESTE","BAHIA","719.25695",10441,5987,5981,6,"2.6"
2928604,"SANTO AMARO","NORDESTE","BAHIA","494.5023838",56012,29013,28998,15,"2.7"
2928703,"SANTO ANTÔNIO DE JESUS","NORDESTE","BAHIA","261.7399719",103055,48200,48165,35,"2.7"
2928802,"SANTO ESTÊVÃO","NORDESTE","BAHIA","360.3343665",52276,22411,22392,19,"3"
2928901,"SÃO DESIDÉRIO","NORDESTE","BAHIA","15156.7117802",32828,15369,15163,206,"3.1"
2928950,"SÃO DOMINGOS","NORDESTE","BAHIA","289.9630878",8426,4469,4468,1,"2.5"
2929008,"SÃO FÉLIX","NORDESTE","BAHIA","103.2264686",11026,4994,4989,5,"2.8"
2929057,"SÃO FÉLIX DO CORIBE","NORDESTE","BAHIA","1751.6705043",15194,6949,6943,6,"2.9"
2929107,"SÃO FELIPE","NORDESTE","BAHIA","222.4074857",20283,9335,9326,9,"2.7"
2929206,"SÃO FRANCISCO DO CONDE","NORDESTE","BAHIA","269.7152874",38733,19241,19229,12,"2.8"
2929255,"SÃO GABRIEL","NORDESTE","BAHIA","1146.0543678",18600,8847,8846,1,"2.9"
2929305,"SÃO GONÇALO DOS CAMPOS","NORDESTE","BAHIA","294.7680516",39513,17695,17683,12,"2.9"
2929354,"SÃO JOSÉ DA VITÓRIA","NORDESTE","BAHIA","127.9251175",5315,2938,2938,0,"2.6"
2929370,"SÃO JOSÉ DO JACUÍPE","NORDESTE","BAHIA","362.3652142",10187,5698,5695,3,"2.7"
2929404,"SÃO MIGUEL DAS MATAS","NORDESTE","BAHIA","230.905958",10334,4862,4859,3,"2.7"
2929503,"SÃO SEBASTIÃO DO PASSÉ","NORDESTE","BAHIA","536.6777807",40958,20212,20200,12,"2.7"
2929602,"SAPEAÇU","NORDESTE","BAHIA","131.2177401",17963,8010,8008,2,"2.8"
2929701,"SÁTIRO DIAS","NORDESTE","BAHIA","949.2230478",16008,8006,8000,6,"2.8"
2929750,"SAUBARA","NORDESTE","BAHIA","166.4276292",11438,13627,13609,18,"2.6"
2929800,"SAÚDE","NORDESTE","BAHIA","509.0980134",10478,5949,5947,2,"2.6"
2929909,"SEABRA","NORDESTE","BAHIA","2402.1695981",46160,22493,22467,26,"2.9"
2930006,"SEBASTIÃO LARANJEIRAS","NORDESTE","BAHIA","1984.5107169",9360,4737,4734,3,"2.9"
2930105,"SENHOR DO BONFIM","NORDESTE","BAHIA","789.3605955",74523,35063,35037,26,"2.8"
2930154,"SERRA DO RAMALHO","NORDESTE","BAHIA","2340.6838029",34222,15253,15243,10,"3"
2930204,"SENTO SÉ","NORDESTE","BAHIA","11980.1719033",38154,14445,14429,16,"3.2"
2930303,"SERRA DOURADA","NORDESTE","BAHIA","1592.2450696",17066,8197,8191,6,"2.9"
2930402,"SERRA PRETA","NORDESTE","BAHIA","595.2968468",17996,7667,7666,1,"3.1"
2930501,"SERRINHA","NORDESTE","BAHIA","583.3113565",80435,39114,39074,40,"2.8"
2930600,"SERROLÂNDIA","NORDESTE","BAHIA","322.0223381",13335,7616,7603,13,"2.6"
2930709,"SIMÕES FILHO","NORDESTE","BAHIA","201.5283945",114559,56268,56224,44,"2.7"
2930758,"SÍTIO DO MATO","NORDESTE","BAHIA","1627.8054947",13408,5361,5345,16,"3.3"
2930766,"SÍTIO DO QUINTO","NORDESTE","BAHIA","684.0889941",14773,6875,6872,3,"2.9"
2930774,"SOBRADINHO","NORDESTE","BAHIA","1355.9723512",25475,10245,10234,11,"3"
2930808,"SOUTO SOARES","NORDESTE","BAHIA","1026.6342671",17054,8504,8503,1,"3"
2930907,"TABOCAS DO BREJO VELHO","NORDESTE","BAHIA","1437.189013",11979,5239,5237,2,"3.1"
2931004,"TANHAÇU","NORDESTE","BAHIA","1277.5145227",21006,9419,9411,8,"2.9"
2931053,"TANQUE NOVO","NORDESTE","BAHIA","729.5157731",17158,7332,7325,7,"3.1"
2931103,"TANQUINHO","NORDESTE","BAHIA","243.8389806",7717,3354,3352,2,"3"
2931202,"TAPEROÁ","NORDESTE","BAHIA","454.0805718",18044,8585,8579,6,"2.9"
2931301,"TAPIRAMUTÁ","NORDESTE","BAHIA","714.691487",15818,6216,6211,5,"3.1"
2931350,"TEIXEIRA DE FREITAS","NORDESTE","BAHIA","1165.6215841",145216,64915,64878,37,"2.8"
2931400,"TEODORO SAMPAIO","NORDESTE","BAHIA","244.6134037",7110,3909,3907,2,"2.7"
2931509,"TEOFILÂNDIA","NORDESTE","BAHIA","351.891961",21176,10528,10517,11,"2.9"
2931608,"TEOLÂNDIA","NORDESTE","BAHIA","289.781734",15332,5611,5610,1,"3.2"
2931707,"TERRA NOVA","NORDESTE","BAHIA","193.2410345",10798,5310,5306,4,"2.8"
2931806,"TREMEDAL","NORDESTE","BAHIA","2010.3156026",16296,8557,8557,0,"2.8"
2931905,"TUCANO","NORDESTE","BAHIA","2198.2366313",48736,25332,25317,15,"2.8"
2932002,"UAUÁ","NORDESTE","BAHIA","3060.1158812",24665,12224,12206,18,"2.8"
2932101,"UBAÍRA","NORDESTE","BAHIA","659.0796455",18626,9400,9394,6,"2.7"
2932200,"UBAITABA","NORDESTE","BAHIA","181.101823",17596,8799,8796,3,"2.7"
2932309,"UBATÃ","NORDESTE","BAHIA","177.6433729",16094,7687,7682,5,"2.7"
2932408,"UIBAÍ","NORDESTE","BAHIA","545.2976517",13432,6933,6933,0,"2.8"
2932457,"UMBURANAS","NORDESTE","BAHIA","1775.6331984",13642,7259,7237,22,"3"
2932507,"UNAS","NORDESTE","BAHIA","1126.7329673",18131,10753,10726,27,"2.6"
2932606,"URANDI","NORDESTE","BAHIA","902.4021213",15355,6840,6838,2,"3"
2932705,"URUÇUCA","NORDESTE","BAHIA","510.0978883",21420,11653,11618,35,"2.7"
2932804,"UTINGA","NORDESTE","BAHIA","633.7597386",16277,8205,8193,12,"2.7"
2932903,"VALENÇA","NORDESTE","BAHIA","1123.9748576",85655,44994,44840,154,"2.6"
2933000,"VALENTE","NORDESTE","BAHIA","394.8770363",24362,12277,12272,5,"2.7"
2933059,"VÁRZEA DA ROÇA","NORDESTE","BAHIA","468.4067191",13800,7179,7177,2,"2.7"
2933109,"VÁRZEA DO POÇO","NORDESTE","BAHIA","206.4775101",8101,4723,4722,1,"2.5"
2933158,"VÁRZEA NOVA","NORDESTE","BAHIA","1225.8918396",13377,7207,7206,1,"2.7"
2933174,"VARZEDO","NORDESTE","BAHIA","221.3989819",9913,4655,4654,1,"2.7"
2933208,"VERA CRUZ","NORDESTE","BAHIA","297.5372256",42529,44910,44843,67,"2.6"
2933257,"VEREDA","NORDESTE","BAHIA","782.1590056",6003,3132,3131,1,"2.7"
2933307,"VITÓRIA DA CONQUISTA","NORDESTE","BAHIA","3254.1861163",370879,160658,160525,133,"2.9"
2933406,"WAGNER","NORDESTE","BAHIA","522.3695718",9503,4308,4304,4,"2.9"
2933455,"WANDERLEY","NORDESTE","BAHIA","2920.5785454",12968,5862,5855,7,"3"
2933505,"WENCESLAU GUIMARÃES","NORDESTE","BAHIA","655.0571875",24474,11406,11399,7,"2.9"
2933604,"XIQUE-XIQUE","NORDESTE","BAHIA","5079.661734",44757,18031,18001,30,"3.3"
3100104,"ABADIA DOS DOURADOS","SUDESTE","MINAS GERAIS","880.4612352",6272,3477,3475,2,"2.4"
3100203,"ABAETÉ","SUDESTE","MINAS GERAIS","1817.0669005",22675,12156,12144,12,"2.5"
3100302,"ABRE CAMPO","SUDESTE","MINAS GERAIS","470.5509774",13927,6566,6558,8,"2.8"
3100401,"ACAIACA","SUDESTE","MINAS GERAIS","101.8859886",3909,2056,2043,13,"2.6"
3100500,"AÇUCENA","SUDESTE","MINAS GERAIS","815.4218812",8943,4536,4530,6,"2.7"
3100609,"ÁGUA BOA","SUDESTE","MINAS GERAIS","1320.3436505",12589,6501,6498,3,"2.8"
3100708,"ÁGUA COMPRIDA","SUDESTE","MINAS GERAIS","492.1667429",2108,1469,1468,1,"2.6"
3100807,"AGUANIL","SUDESTE","MINAS GERAIS","232.0911522",4357,2812,2811,1,"2.7"
3100906,"ÁGUAS FORMOSAS","SUDESTE","MINAS GERAIS","820.0789726",18448,8241,8234,7,"2.8"
3101003,"ÁGUAS VERMELHAS","SUDESTE","MINAS GERAIS","1256.6073667",14037,5300,5294,6,"3.4"
3101102,"AIMORÉS","SUDESTE","MINAS GERAIS","1348.9129061",25269,12587,12566,21,"2.6"
3101201,"AIURUOCA","SUDESTE","MINAS GERAIS","649.6795899",6233,3657,3637,20,"2.5"
3101300,"ALAGOA","SUDESTE","MINAS GERAIS","161.3556169",2749,1510,1504,6,"2.7"
3101409,"ALBERTINA","SUDESTE","MINAS GERAIS","58.0099827",2952,1397,1397,0,"2.8"
3101508,"ALÉM PARAÍBA","SUDESTE","MINAS GERAIS","510.2496741",30717,14797,14787,10,"2.6"
3101607,"ALFENAS","SUDESTE","MINAS GERAIS","850.4455028",78970,38966,38930,36,"2.7"
3101631,"ALFREDO VASCONCELOS","SUDESTE","MINAS GERAIS","130.8145572",6931,3142,3142,0,"2.8"
3101706,"ALMENARA","SUDESTE","MINAS GERAIS","2294.4258819",40364,18366,18347,19,"2.8"
3101805,"ALPERCATA","SUDESTE","MINAS GERAIS","166.9723842",6903,3862,3859,3,"2.5"
3101904,"ALPINÓPOLIS","SUDESTE","MINAS GERAIS","460.6854719",18300,8398,8392,6,"2.8"
3102001,"ALTEROSA","SUDESTE","MINAS GERAIS","362.0096599",13915,7371,7366,5,"2.6"
3102050,"ALTO CAPARAÓ","SUDESTE","MINAS GERAIS","103.6903542",5795,2866,2850,16,"2.6"
3102100,"ALTO RIO DOCE","SUDESTE","MINAS GERAIS","518.0526726",10891,5671,5667,4,"2.7"
3102209,"ALVARENGA","SUDESTE","MINAS GERAIS","278.1749402",3975,2258,2254,4,"2.6"
3102308,"ALVINÓPOLIS","SUDESTE","MINAS GERAIS","599.4433089",15059,7113,7104,9,"2.7"
3102407,"ALVORADA DE MINAS","SUDESTE","MINAS GERAIS","374.0084881",4159,1952,1951,1,"3"
3102506,"AMPARO DO SERRA","SUDESTE","MINAS GERAIS","136.1859302",4541,2097,2095,2,"2.9"
3102605,"ANDRADAS","SUDESTE","MINAS GERAIS","469.3963546",40553,18791,18778,13,"2.7"
3102704,"CACHOEIRA DE PAJEÚ","SUDESTE","MINAS GERAIS","695.6723289",9110,4192,4184,8,"3.1"
3102803,"ANDRELÂNDIA","SUDESTE","MINAS GERAIS","1005.284626",11927,6801,6773,28,"2.6"
3102852,"ANGELÂNDIA","SUDESTE","MINAS GERAIS","185.2108132",7718,3391,3389,2,"3"
3102902,"ANTÔNIO CARLOS","SUDESTE","MINAS GERAIS","529.9149936",11095,5485,5479,6,"2.7"
3103009,"ANTÔNIO DIAS","SUDESTE","MINAS GERAIS","787.0606371",9219,4863,4841,22,"2.9"
3103108,"ANTÔNIO PRADO DE MINAS","SUDESTE","MINAS GERAIS","83.8023342",1538,828,827,1,"2.6"
3103207,"ARAÇAÍ","SUDESTE","MINAS GERAIS","187.5304762",2181,1428,1426,2,"2.6"
3103306,"ARACITABA","SUDESTE","MINAS GERAIS","106.6082264",2049,1211,1210,1,"2.4"
3103405,"ARAÇUAÍ","SUDESTE","MINAS GERAIS","2236.2789858",34297,15703,15681,22,"2.8"
3103504,"ARAGUARI","SUDESTE","MINAS GERAIS","2729.7772941",117808,55313,55246,67,"2.7"
3103603,"ARANTINA","SUDESTE","MINAS GERAIS","89.420025",2915,1714,1701,13,"2.6"
3103702,"ARAPONGA","SUDESTE","MINAS GERAIS","303.7926275",8048,3671,3666,5,"2.8"
3103751,"ARAPORÃ","SUDESTE","MINAS GERAIS","294.3535193",8479,3365,3365,0,"2.9"
3103801,"ARAPUÁ","SUDESTE","MINAS GERAIS","173.8937051",2631,1387,1386,1,"2.5"
3103900,"ARAÚJOS","SUDESTE","MINAS GERAIS","245.522063",9199,4314,4312,2,"2.7"
3104007,"ARAXÁ","SUDESTE","MINAS GERAIS","1164.0615759",111691,47752,47601,151,"2.8"
3104106,"ARCEBURGO","SUDESTE","MINAS GERAIS","162.8751034",9177,4120,4118,2,"2.7"
3104205,"ARCOS","SUDESTE","MINAS GERAIS","509.8734507",41416,19290,19250,40,"2.7"
3104304,"AREADO","SUDESTE","MINAS GERAIS","283.1235331",13881,6937,6922,15,"2.7"
3104403,"ARGIRITA","SUDESTE","MINAS GERAIS","159.3779545",2688,1452,1452,0,"2.7"
3104452,"ARICANDUVA","SUDESTE","MINAS GERAIS","243.3288333",4719,2212,2209,3,"2.8"
3104502,"ARINOS","SUDESTE","MINAS GERAIS","5279.4190363",17272,8327,8303,24,"2.8"
3104601,"ASTOLFO DUTRA","SUDESTE","MINAS GERAIS","158.8905722",14138,6224,6215,9,"2.7"
3104700,"ATALÉIA","SUDESTE","MINAS GERAIS","1836.9251159",13736,6590,6584,6,"2.8"
3104809,"AUGUSTO DE LIMA","SUDESTE","MINAS GERAIS","1254.831614",4538,2645,2639,6,"2.6"
3104908,"BAEPENDI","SUDESTE","MINAS GERAIS","750.5536974",18366,8948,8924,24,"2.7"
3105004,"BALDIM","SUDESTE","MINAS GERAIS","556.2664219",7492,4923,4915,8,"2.5"
3105103,"BAMBUÍ","SUDESTE","MINAS GERAIS","1455.818688",23546,13313,13283,30,"2.4"
3105202,"BANDEIRA","SUDESTE","MINAS GERAIS","483.7887845",4741,2202,2200,2,"2.7"
3105301,"BANDEIRA DO SUL","SUDESTE","MINAS GERAIS","47.2660345",5943,2871,2868,3,"2.7"
3105400,"BARÃO DE COCAIS","SUDESTE","MINAS GERAIS","340.1398336",30778,13638,13521,117,"2.9"
3105509,"BARÃO DO MONTE ALTO","SUDESTE","MINAS GERAIS","198.3128486",4964,2705,2704,1,"2.6"
3105608,"BARBACENA","SUDESTE","MINAS GERAIS","759.1857785",125317,56122,56040,82,"2.7"
3105707,"BARRA LONGA","SUDESTE","MINAS GERAIS","383.6280115",5666,2933,2933,0,"2.8"
3105905,"BARROSO","SUDESTE","MINAS GERAIS","82.0697455",20080,8750,8743,7,"2.7"
3106002,"BELA VISTA DE MINAS","SUDESTE","MINAS GERAIS","109.1430575",10167,4106,4103,3,"2.8"
3106101,"BELMIRO BRAGA","SUDESTE","MINAS GERAIS","393.0861513",3244,1876,1872,4,"2.8"
3106200,"BELO HORIZONTE","SUDESTE","MINAS GERAIS","331.3535943",2315560,1027170,1025822,1348,"2.6"
3106309,"BELO ORIENTE","SUDESTE","MINAS GERAIS","334.9092619",23928,10029,10020,9,"3"
3106408,"BELO VALE","SUDESTE","MINAS GERAIS","365.9230406",8627,4979,4964,15,"2.7"
3106507,"BERILO","SUDESTE","MINAS GERAIS","587.1059883",9826,5260,5257,3,"2.8"
3106606,"BERTÓPOLIS","SUDESTE","MINAS GERAIS","427.8029327",4451,2013,2011,2,"3"
3106655,"BERIZAL","SUDESTE","MINAS GERAIS","488.7561187",4201,1905,1905,0,"3"
3106705,"BETIM","SUDESTE","MINAS GERAIS","344.0620972",411846,176262,176184,78,"2.8"
3106804,"BIAS FORTES","SUDESTE","MINAS GERAIS","283.5354209",3361,1860,1859,1,"2.6"
3106903,"BICAS","SUDESTE","MINAS GERAIS","140.0823443",13978,6866,6861,5,"2.5"
3107000,"BIQUINHAS","SUDESTE","MINAS GERAIS","458.9476887",2383,1400,1398,2,"2.3"
3107109,"BOA ESPERANÇA","SUDESTE","MINAS GERAIS","860.6689999",39848,17576,17547,29,"2.9"
3107208,"BOCAINA DE MINAS","SUDESTE","MINAS GERAIS","503.7699052",5348,4552,4469,83,"2.4"
3107307,"BOCAIÚVA","SUDESTE","MINAS GERAIS","3206.7567462",48032,22533,22513,20,"2.8"
3107406,"BOM DESPACHO","SUDESTE","MINAS GERAIS","1213.5455877",51737,25040,25021,19,"2.7"
3107505,"BOM JARDIM DE MINAS","SUDESTE","MINAS GERAIS","412.0208308",6783,4212,4203,9,"2.5"
3107604,"BOM JESUS DA PENHA","SUDESTE","MINAS GERAIS","208.3494062",4474,2250,2248,2,"2.7"
3107703,"BOM JESUS DO AMPARO","SUDESTE","MINAS GERAIS","195.6110014",5631,3161,3156,5,"2.8"
3107802,"BOM JESUS DO GALHO","SUDESTE","MINAS GERAIS","592.2885564",14536,8117,8116,1,"2.6"
3107901,"BOM REPOUSO","SUDESTE","MINAS GERAIS","229.8448804",12649,5246,5243,3,"2.8"
3108008,"BOM SUCESSO","SUDESTE","MINAS GERAIS","705.0461384",17151,8558,8553,5,"2.7"
3108107,"BONFIM","SUDESTE","MINAS GERAIS","301.8652636",7434,5863,5858,5,"2.4"
3108206,"BONFINÓPOLIS DE MINAS","SUDESTE","MINAS GERAIS","1850.4873668",5528,2977,2940,37,"2.6"
3108255,"BONITO DE MINAS","SUDESTE","MINAS GERAIS","3936.4552903",10204,4346,4340,6,"3.4"
3108305,"BORDA DA MATA","SUDESTE","MINAS GERAIS","301.1080372",17404,8164,8159,5,"2.6"
3108404,"BOTELHOS","SUDESTE","MINAS GERAIS","334.0887158",14828,7564,7558,6,"2.6"
3108503,"BOTUMIRIM","SUDESTE","MINAS GERAIS","1568.884258",5790,3347,3340,7,"2.8"
3108552,"BRASILÂNDIA DE MINAS","SUDESTE","MINAS GERAIS","2509.69358",15020,6850,6826,24,"2.9"
3108602,"BRASÍLIA DE MINAS","SUDESTE","MINAS GERAIS","1399.4841254",32025,14359,14346,13,"3"
3108701,"BRÁS PIRES","SUDESTE","MINAS GERAIS","223.3513883",4260,2442,2439,3,"2.6"
3108800,"BRAÚNAS","SUDESTE","MINAS GERAIS","378.3182849",4441,2254,2251,3,"2.8"
3108909,"BRAZÓPOLIS","SUDESTE","MINAS GERAIS","367.6882703",14246,7573,7560,13,"2.6"
3109006,"BRUMADINHO","SUDESTE","MINAS GERAIS","639.4343441",38915,21955,21786,169,"2.8"
3109105,"BUENO BRANDÃO","SUDESTE","MINAS GERAIS","356.1504608",10911,5634,5614,20,"2.6"
3109204,"BUENÓPOLIS","SUDESTE","MINAS GERAIS","1599.8811757",9150,4868,4857,11,"2.7"
3109253,"BUGRE","SUDESTE","MINAS GERAIS","161.491183",4041,1906,1905,1,"2.8"
3109303,"BURITIS","SUDESTE","MINAS GERAIS","5225.1860588",24030,11690,11610,80,"2.7"
3109402,"BURITIZEIRO","SUDESTE","MINAS GERAIS","7218.4013133",23910,11084,11064,20,"2.9"
3109451,"CABECEIRA GRANDE","SUDESTE","MINAS GERAIS","1033.0554453",6627,3896,3894,2,"2.5"
3109501,"CABO VERDE","SUDESTE","MINAS GERAIS","368.2055378",11410,5884,5842,42,"2.7"
3109600,"CACHOEIRA DA PRATA","SUDESTE","MINAS GERAIS","61.4254797",3693,1771,1770,1,"2.7"
3109709,"CACHOEIRA DE MINAS","SUDESTE","MINAS GERAIS","304.2427709",11883,5899,5891,8,"2.7"
3109808,"CACHOEIRA DOURADA","SUDESTE","MINAS GERAIS","203.0697201",2315,1241,1236,5,"2.7"
3109907,"CAETANÓPOLIS","SUDESTE","MINAS GERAIS","156.0394351",11435,6278,6269,9,"2.7"
3110004,"CAETÉ","SUDESTE","MINAS GERAIS","542.5308786",38776,18632,18598,34,"2.8"
3110103,"CAIANA","SUDESTE","MINAS GERAIS","106.4651601",5304,2450,2448,2,"2.7"
3110202,"CAJURI","SUDESTE","MINAS GERAIS","83.0383775",4088,1789,1789,0,"2.9"
3110301,"CALDAS","SUDESTE","MINAS GERAIS","711.4136658",14217,8548,8535,13,"2.5"
3110400,"CAMACHO","SUDESTE","MINAS GERAIS","223.0006116",2838,1465,1464,1,"2.7"
3110509,"CAMANDUCAIA","SUDESTE","MINAS GERAIS","528.6878047",26097,13969,13806,163,"2.7"
3110608,"CAMBUÍ","SUDESTE","MINAS GERAIS","244.567272",29536,14408,14398,10,"2.6"
3110707,"CAMBUQUIRA","SUDESTE","MINAS GERAIS","246.379688",12313,6014,6002,12,"2.7"
3110806,"CAMPANÁRIO","SUDESTE","MINAS GERAIS","442.3980929",2923,1685,1678,7,"2.7"
3110905,"CAMPANHA","SUDESTE","MINAS GERAIS","335.5867254",15935,7261,7246,15,"2.8"
3111002,"CAMPESTRE","SUDESTE","MINAS GERAIS","577.8425639",20696,10618,10607,11,"2.6"
3111101,"CAMPINA VERDE","SUDESTE","MINAS GERAIS","3650.749383",18011,10448,10435,13,"2.5"
3111150,"CAMPO AZUL","SUDESTE","MINAS GERAIS","505.9135932",3714,1704,1703,1,"2.9"
3111200,"CAMPO BELO","SUDESTE","MINAS GERAIS","528.2246163",52277,24330,24314,16,"2.6"
3111309,"CAMPO DO MEIO","SUDESTE","MINAS GERAIS","275.4260018",11377,5452,5443,9,"2.8"
3111408,"CAMPO FLORIDO","SUDESTE","MINAS GERAIS","1264.2454953",8466,3778,3769,9,"2.8"
3111507,"CAMPOS ALTOS","SUDESTE","MINAS GERAIS","710.6448587",12979,5750,5744,6,"2.8"
3111606,"CAMPOS GERAIS","SUDESTE","MINAS GERAIS","769.5036234",26105,13133,13115,18,"2.7"
3111705,"CANAÃ","SUDESTE","MINAS GERAIS","174.9004856",4715,2203,2202,1,"2.8"
3111804,"CANÁPOLIS","SUDESTE","MINAS GERAIS","843.598798",10608,4823,4817,6,"2.6"
3111903,"CANA VERDE","SUDESTE","MINAS GERAIS","212.7206546",5272,3018,3015,3,"2.7"
3112000,"CANDEIAS","SUDESTE","MINAS GERAIS","720.5118294",14001,7606,7595,11,"2.6"
3112059,"CANTAGALO","SUDESTE","MINAS GERAIS","141.8549688",3974,1890,1887,3,"2.9"
3112109,"CAPARAÓ","SUDESTE","MINAS GERAIS","130.6937648",5048,2402,2400,2,"2.7"
3112208,"CAPELA NOVA","SUDESTE","MINAS GERAIS","111.0731667",4362,2351,2349,2,"2.6"
3112307,"CAPELINHA","SUDESTE","MINAS GERAIS","965.2921808",39626,17715,17698,17,"2.8"
3112406,"CAPETINGA","SUDESTE","MINAS GERAIS","297.9371651",6562,3416,3413,3,"2.7"
3112505,"CAPIM BRANCO","SUDESTE","MINAS GERAIS","95.3330466",10663,4763,4761,2,"3"
3112604,"CAPINÓPOLIS","SUDESTE","MINAS GERAIS","620.7156414",14655,6695,6688,7,"2.6"
3112653,"CAPITÃO ANDRADE","SUDESTE","MINAS GERAIS","279.0884347",4585,2485,2482,3,"2.6"
3112703,"CAPITÃO ENÉAS","SUDESTE","MINAS GERAIS","971.5764552",14108,6400,6394,6,"3.1"
3112802,"CAPITÓLIO","SUDESTE","MINAS GERAIS","521.8016029",10380,6241,6191,50,"2.7"
3112901,"CAPUTIRA","SUDESTE","MINAS GERAIS","187.703598",8936,3760,3758,2,"2.9"
3113008,"CARAÍ","SUDESTE","MINAS GERAIS","1242.3453934",19548,9530,9525,5,"2.8"
3113107,"CARANAÍBA","SUDESTE","MINAS GERAIS","159.9495374",2933,1487,1487,0,"2.8"
3113206,"CARANDAÍ","SUDESTE","MINAS GERAIS","487.2799768",23812,10148,10143,5,"2.9"
3113305,"CARANGOLA","SUDESTE","MINAS GERAIS","353.4044163",31240,15791,15780,11,"2.5"
3113404,"CARATINGA","SUDESTE","MINAS GERAIS","1258.4785584",87360,43134,43106,28,"2.6"
3113503,"CARBONITA","SUDESTE","MINAS GERAIS","1456.0951195",8512,5248,5242,6,"2.5"
3113602,"CAREAÇU","SUDESTE","MINAS GERAIS","181.0093968",6816,3084,3081,3,"2.8"
3113701,"CARLOS CHAGAS","SUDESTE","MINAS GERAIS","3202.9836221",18615,9224,9214,10,"2.6"
3113800,"CARMÉSIA","SUDESTE","MINAS GERAIS","259.1034699",2605,1249,1245,4,"2.9"
3113909,"CARMO DA CACHOEIRA","SUDESTE","MINAS GERAIS","506.3333326",11547,5250,5210,40,"2.9"
3114006,"CARMO DA MATA","SUDESTE","MINAS GERAIS","357.1784349",11019,5732,5729,3,"2.6"
3114105,"CARMO DE MINAS","SUDESTE","MINAS GERAIS","322.285277",13797,5853,5841,12,"2.9"
3114204,"CARMO DO CAJURU","SUDESTE","MINAS GERAIS","455.8076738",23479,12118,12111,7,"2.7"
3114303,"CARMO DO PARANAÍBA","SUDESTE","MINAS GERAIS","1307.8623442",29011,13931,13923,8,"2.6"
3114402,"CARMO DO RIO CLARO","SUDESTE","MINAS GERAIS","1065.6846283",20954,11246,11227,19,"2.6"
3114501,"CARMÓPOLIS DE MINAS","SUDESTE","MINAS GERAIS","400.0099642",18003,8603,8587,16,"2.8"
3114550,"CARNEIRINHO","SUDESTE","MINAS GERAIS","2063.4624192",9422,4948,4941,7,"2.5"
3114600,"CARRANCAS","SUDESTE","MINAS GERAIS","727.8935901",4049,2531,2487,44,"2.6"
3114709,"CARVALHÓPOLIS","SUDESTE","MINAS GERAIS","81.1006426",3341,1722,1720,2,"2.7"
3114808,"CARVALHOS","SUDESTE","MINAS GERAIS","282.2544198",4422,2453,2443,10,"2.6"
3114907,"CASA GRANDE","SUDESTE","MINAS GERAIS","157.7266553",2214,1063,1063,0,"2.9"
3115003,"CASCALHO RICO","SUDESTE","MINAS GERAIS","367.3080404",2712,1780,1772,8,"2.5"
3115102,"CÁSSIA","SUDESTE","MINAS GERAIS","665.8017892",17155,9437,9429,8,"2.7"
3115201,"CONCEIÇÃO DA BARRA DE MINAS","SUDESTE","MINAS GERAIS","273.013707",3560,1924,1922,2,"2.7"
3115300,"CATAGUASES","SUDESTE","MINAS GERAIS","491.7672912",66261,31782,31761,21,"2.6"
3115359,"CATAS ALTAS","SUDESTE","MINAS GERAIS","240.0420465",5473,2708,2683,25,"2.8"
3115409,"CATAS ALTAS DA NORUEGA","SUDESTE","MINAS GERAIS","141.6223996",3110,1594,1593,1,"2.8"
3115458,"CATUJI","SUDESTE","MINAS GERAIS","419.3799917",7030,3677,3674,3,"2.8"
3115474,"CATUTI","SUDESTE","MINAS GERAIS","287.8122666",4739,2408,2406,2,"2.8"
3115508,"CAXAMBU","SUDESTE","MINAS GERAIS","100.4828109",21056,10978,10963,15,"2.6"
3115607,"CEDRO DO ABAETÉ","SUDESTE","MINAS GERAIS","283.2110248",1081,690,690,0,"2.4"
3115706,"CENTRAL DE MINAS","SUDESTE","MINAS GERAIS","204.3281433",6171,3616,3614,2,"2.5"
3115805,"CENTRALINA","SUDESTE","MINAS GERAIS","322.3846151",10207,4165,4161,4,"2.7"
3115904,"CHÁCARA","SUDESTE","MINAS GERAIS","152.8069412",3075,2518,2515,3,"2.6"
3116001,"CHALÉ","SUDESTE","MINAS GERAIS","212.6744288",6075,2986,2982,4,"2.7"
3116100,"CHAPADA DO NORTE","SUDESTE","MINAS GERAIS","830.8334078",10337,5895,5886,9,"3"
3116159,"CHAPADA GAÚCHA","SUDESTE","MINAS GERAIS","3255.1892975",12355,5080,5076,4,"3.2"
3116209,"CHIADOR","SUDESTE","MINAS GERAIS","252.8516018",2800,1609,1609,0,"2.7"
3116308,"CIPOTÂNEA","SUDESTE","MINAS GERAIS","153.4791242",5581,3052,3046,6,"2.7"
3116407,"CLARAVAL","SUDESTE","MINAS GERAIS","227.6273298",4658,2407,2402,5,"2.8"
3116506,"CLARO DOS POÇÕES","SUDESTE","MINAS GERAIS","720.4240177",7166,4484,4479,5,"2.6"
3116605,"CLÁUDIO","SUDESTE","MINAS GERAIS","630.7058668",30159,14216,14196,20,"2.8"
3116704,"COIMBRA","SUDESTE","MINAS GERAIS","106.8754203",7117,3790,3784,6,"2.5"
3116803,"COLUNA","SUDESTE","MINAS GERAIS","348.4917774",8163,3854,3847,7,"2.7"
3116902,"COMENDADOR GOMES","SUDESTE","MINAS GERAIS","1041.0471209",2773,1551,1548,3,"2.6"
3117009,"COMERCINHO","SUDESTE","MINAS GERAIS","654.9608464",6660,4025,4014,11,"2.6"
3117108,"CONCEIÇÃO DA APARECIDA","SUDESTE","MINAS GERAIS","352.5210074",10371,5362,5356,6,"2.7"
3117207,"CONCEIÇÃO DAS PEDRAS","SUDESTE","MINAS GERAIS","102.2061419",2772,1284,1282,2,"2.7"
3117306,"CONCEIÇÃO DAS ALAGOAS","SUDESTE","MINAS GERAIS","1340.2498431",28381,11524,11508,16,"2.9"
3117405,"CONCEIÇÃO DE IPANEMA","SUDESTE","MINAS GERAIS","253.9350897",4409,2181,2178,3,"2.6"
3117504,"CONCEIÇÃO DO MATO DENTRO","SUDESTE","MINAS GERAIS","1720.0396678",23163,12374,12301,73,"2.9"
3117603,"CONCEIÇÃO DO PARÁ","SUDESTE","MINAS GERAIS","250.3059395",5415,4029,4022,7,"2.6"
3117702,"CONCEIÇÃO DO RIO VERDE","SUDESTE","MINAS GERAIS","369.6812433",12541,6100,6090,10,"2.7"
3117801,"CONCEIÇÃO DOS OUROS","SUDESTE","MINAS GERAIS","180.2363606",10880,4995,4992,3,"2.7"
3117836,"CÔNEGO MARINHO","SUDESTE","MINAS GERAIS","1610.4694951",7237,3226,3222,4,"3"
3117876,"CONFINS","SUDESTE","MINAS GERAIS","42.3547099",7350,3359,3357,2,"2.9"
3117900,"CONGONHAL","SUDESTE","MINAS GERAIS","205.1251092",11083,5633,5629,4,"2.6"
3118007,"CONGONHAS","SUDESTE","MINAS GERAIS","304.0665433",52890,22740,22683,57,"2.9"
3118106,"CONGONHAS DO NORTE","SUDESTE","MINAS GERAIS","405.6713875",4831,2723,2717,6,"2.8"
3118205,"CONQUISTA","SUDESTE","MINAS GERAIS","618.3630236",6694,3586,3583,3,"2.6"
3118304,"CONSELHEIRO LAFAIETE","SUDESTE","MINAS GERAIS","370.2456443",131621,58285,58167,118,"2.8"
3118403,"CONSELHEIRO PENA","SUDESTE","MINAS GERAIS","1483.8825542",20824,11321,11296,25,"2.6"
3118502,"CONSOLAÇÃO","SUDESTE","MINAS GERAIS","89.121848",1563,895,889,6,"2.5"
3118601,"CONTAGEM","SUDESTE","MINAS GERAIS","194.7464284",621863,267758,267613,145,"2.7"
3118700,"COQUEIRAL","SUDESTE","MINAS GERAIS","296.1625907",9023,4452,4447,5,"2.8"
3118809,"CORAÇÃO DE JESUS","SUDESTE","MINAS GERAIS","2225.2159853",25377,13116,13109,7,"2.7"
3118908,"CORDISBURGO","SUDESTE","MINAS GERAIS","823.6542374",7547,4361,4355,6,"2.5"
3119005,"CORDISLÂNDIA","SUDESTE","MINAS GERAIS","179.5426414",3200,1724,1723,1,"2.8"
3119104,"CORINTO","SUDESTE","MINAS GERAIS","2525.3969122",23532,11012,11002,10,"2.7"
3119203,"COROACI","SUDESTE","MINAS GERAIS","576.2737735",10884,4337,4331,6,"3.3"
3119302,"COROMANDEL","SUDESTE","MINAS GERAIS","3313.3134079",28894,15097,15078,19,"2.5"
3119401,"CORONEL FABRICIANO","SUDESTE","MINAS GERAIS","221.2517809",104736,43598,43570,28,"2.7"
3119500,"CORONEL MURTA","SUDESTE","MINAS GERAIS","815.4129107",8200,3774,3770,4,"2.8"
3119609,"CORONEL PACHECO","SUDESTE","MINAS GERAIS","131.5113882",2762,1596,1596,0,"2.8"
3119708,"CORONEL XAVIER CHAVES","SUDESTE","MINAS GERAIS","140.9536706",3486,1867,1865,2,"2.8"
3119807,"CÓRREGO DANTA","SUDESTE","MINAS GERAIS","657.4252687",2960,2079,2077,2,"2.4"
3119906,"CÓRREGO DO BOM JESUS","SUDESTE","MINAS GERAIS","123.6507814",4272,2699,2698,1,"2.5"
3119955,"CÓRREGO FUNDO","SUDESTE","MINAS GERAIS","101.1120719",6133,2927,2926,1,"2.8"
3120003,"CÓRREGO NOVO","SUDESTE","MINAS GERAIS","205.38527",2875,1379,1379,0,"2.7"
3120102,"COUTO DE MAGALHÃES DE MINAS","SUDESTE","MINAS GERAIS","485.6537385",4245,2110,2105,5,"2.8"
3120151,"CRISÓLITA","SUDESTE","MINAS GERAIS","966.2022554",5265,2639,2638,1,"2.8"
3120201,"CRISTAIS","SUDESTE","MINAS GERAIS","628.4336352",12197,5799,5794,5,"2.7"
3120300,"CRISTÁLIA","SUDESTE","MINAS GERAIS","840.7022663",5121,2849,2843,6,"3"
3120409,"CRISTIANO OTONI","SUDESTE","MINAS GERAIS","132.8721814",4667,2184,2182,2,"2.9"
3120508,"CRISTINA","SUDESTE","MINAS GERAIS","311.3295714",10374,4612,4608,4,"2.8"
3120607,"CRUCILÂNDIA","SUDESTE","MINAS GERAIS","167.1644742",5434,3139,3125,14,"2.5"
3120706,"CRUZEIRO DA FORTALEZA","SUDESTE","MINAS GERAIS","187.4464044",3521,1516,1516,0,"2.8"
3120805,"CRUZÍLIA","SUDESTE","MINAS GERAIS","522.4192141",15362,7809,7795,14,"2.6"
3120839,"CUPARAQUE","SUDESTE","MINAS GERAIS","226.7504035",3983,2270,2268,2,"2.5"
3120870,"CURRAL DE DENTRO","SUDESTE","MINAS GERAIS","570.9495466",7406,3278,3275,3,"3"
3120904,"CURVELO","SUDESTE","MINAS GERAIS","3296.1998955",80665,37360,37317,43,"2.7"
3121001,"DATAS","SUDESTE","MINAS GERAIS","310.0991165",5465,2474,2474,0,"3"
3121100,"DELFIM MOREIRA","SUDESTE","MINAS GERAIS","408.4727291",7952,4487,4478,9,"2.7"
3121209,"DELFINÓPOLIS","SUDESTE","MINAS GERAIS","1378.4233964",8393,4874,4848,26,"2.8"
3121258,"DELTA","SUDESTE","MINAS GERAIS","102.7838554",10494,4263,4209,54,"3"
3121308,"DESCOBERTO","SUDESTE","MINAS GERAIS","213.1684894",4928,2659,2657,2,"2.7"
3121407,"DESTERRO DE ENTRE RIOS","SUDESTE","MINAS GERAIS","377.1646214",7653,4484,4479,5,"2.5"
3121506,"DESTERRO DO MELO","SUDESTE","MINAS GERAIS","142.2789087",2994,1561,1560,1,"2.6"
3121605,"DIAMANTINA","SUDESTE","MINAS GERAIS","3891.6592554",47702,24765,24654,111,"2.8"
3121704,"DIOGO DE VASCONCELOS","SUDESTE","MINAS GERAIS","165.0908011",3549,2000,1999,1,"2.5"
3121803,"DIONÍSIO","SUDESTE","MINAS GERAIS","339.3752661",6847,3493,3478,15,"2.6"
3121902,"DIVINÉSIA","SUDESTE","MINAS GERAIS","116.9699952",4226,2206,2203,3,"2.7"
3122009,"DIVINO","SUDESTE","MINAS GERAIS","337.7762661",20706,9761,9749,12,"2.7"
3122108,"DIVINO DAS LARANJEIRAS","SUDESTE","MINAS GERAIS","342.248805",4178,2299,2298,1,"2.5"
3122207,"DIVINOLÂNDIA DE MINAS","SUDESTE","MINAS GERAIS","133.1200748",6516,3100,3099,1,"2.8"
3122306,"DIVINÓPOLIS","SUDESTE","MINAS GERAIS","708.1149164",231091,106845,106756,89,"2.6"
3122355,"DIVISA ALEGRE","SUDESTE","MINAS GERAIS","117.8018899",6321,2650,2650,0,"2.9"
3122405,"DIVISA NOVA","SUDESTE","MINAS GERAIS","216.9546872",5851,2657,2654,3,"2.8"
3122454,"DIVISÓPOLIS","SUDESTE","MINAS GERAIS","572.925685",10213,4008,4007,1,"3.2"
3122470,"DOM BOSCO","SUDESTE","MINAS GERAIS","817.3830449",3697,1967,1966,1,"2.6"
3122504,"DOM CAVATI","SUDESTE","MINAS GERAIS","59.5203714",4904,2654,2648,6,"2.5"
3122603,"DOM JOAQUIM","SUDESTE","MINAS GERAIS","398.792807",4899,2484,2448,36,"2.8"
3122702,"DOM SILVÉRIO","SUDESTE","MINAS GERAIS","194.9718131",5228,2446,2445,1,"2.6"
3122801,"DOM VIÇOSO","SUDESTE","MINAS GERAIS","113.9214562",3095,1637,1635,2,"2.6"
3122900,"DONA EUZÉBIA","SUDESTE","MINAS GERAIS","70.2311621",6093,2797,2797,0,"2.8"
3123007,"DORES DE CAMPOS","SUDESTE","MINAS GERAIS","124.8420744",10007,4530,4527,3,"2.7"
3123106,"DORES DE GUANHÃES","SUDESTE","MINAS GERAIS","382.1236296",5029,2334,2329,5,"2.9"
3123205,"DORES DO INDAIÁ","SUDESTE","MINAS GERAIS","1111.2018295",12630,7182,7176,6,"2.4"
3123304,"DORES DO TURVO","SUDESTE","MINAS GERAIS","231.1688452",4987,2542,2539,3,"2.6"
3123403,"DORESÓPOLIS","SUDESTE","MINAS GERAIS","152.912073",1461,843,843,0,"2.5"
3123502,"DOURADOQUARA","SUDESTE","MINAS GERAIS","312.8779966",1829,1121,1119,2,"2.5"
3123528,"DURANDÉ","SUDESTE","MINAS GERAIS","217.4614185",7817,3435,3434,1,"2.9"
3123601,"ELÓI MENDES","SUDESTE","MINAS GERAIS","499.5369471",26336,12621,12617,4,"2.8"
3123700,"ENGENHEIRO CALDAS","SUDESTE","MINAS GERAIS","187.0584846",13622,5135,5131,4,"2.9"
3123809,"ENGENHEIRO NAVARRO","SUDESTE","MINAS GERAIS","608.3058077",6354,3348,3344,4,"2.8"
3123858,"ENTRE FOLHAS","SUDESTE","MINAS GERAIS","85.3902399",5179,2518,2518,0,"2.7"
3123908,"ENTRE RIOS DE MINAS","SUDESTE","MINAS GERAIS","456.7961105",14746,7544,7527,17,"2.7"
3124005,"ERVÁLIA","SUDESTE","MINAS GERAIS","357.4891982",20255,9926,9919,7,"2.6"
3124104,"ESMERALDAS","SUDESTE","MINAS GERAIS","909.7272804",85598,48355,48329,26,"2.8"
3124203,"ESPERA FELIZ","SUDESTE","MINAS GERAIS","317.6376487",24102,11875,11867,8,"2.6"
3124302,"ESPINOSA","SUDESTE","MINAS GERAIS","1868.9695876",30443,13975,13966,9,"2.9"
3124401,"ESPÍRITO SANTO DO DOURADO","SUDESTE","MINAS GERAIS","263.8792536",6611,2872,2868,4,"2.9"
3124500,"ESTIVA","SUDESTE","MINAS GERAIS","243.8720546",11502,5657,5655,2,"2.7"
3124609,"ESTRELA DALVA","SUDESTE","MINAS GERAIS","131.3652413",2186,1367,1365,2,"2.5"
3124708,"ESTRELA DO INDAIÁ","SUDESTE","MINAS GERAIS","635.9811029",2772,1952,1946,6,"2.3"
3124807,"ESTRELA DO SUL","SUDESTE","MINAS GERAIS","822.4540019",6840,3767,3756,11,"2.6"
3124906,"EUGENÓPOLIS","SUDESTE","MINAS GERAIS","309.3954471",10801,5659,5654,5,"2.5"
3125002,"EWBANK DA CÂMARA","SUDESTE","MINAS GERAIS","103.833958",3875,1892,1886,6,"2.8"
3125101,"EXTREMA","SUDESTE","MINAS GERAIS","244.5751165",53482,23141,23058,83,"2.9"
3125200,"FAMA","SUDESTE","MINAS GERAIS","86.0238003",2578,1799,1795,4,"2.6"
3125309,"FARIA LEMOS","SUDESTE","MINAS GERAIS","165.2243785",3188,1650,1648,2,"2.7"
3125408,"FELÍCIO DOS SANTOS","SUDESTE","MINAS GERAIS","357.6215524",5133,2687,2686,1,"2.7"
3125507,"SÃO GONÇALO DO RIO PRETO","SUDESTE","MINAS GERAIS","314.4581249",3032,1808,1794,14,"2.6"
3125606,"FELISBURGO","SUDESTE","MINAS GERAIS","596.2150527",6489,3169,3168,1,"2.8"
3125705,"FELIXLÂNDIA","SUDESTE","MINAS GERAIS","1554.6273613",13978,10992,10967,25,"2.6"
3125804,"FERNANDES TOURINHO","SUDESTE","MINAS GERAIS","151.874561",2789,1464,1462,2,"2.5"
3125903,"FERROS","SUDESTE","MINAS GERAIS","1088.7914277",9590,5186,5180,6,"2.6"
3125952,"FERVEDOURO","SUDESTE","MINAS GERAIS","357.6831929",10445,4737,4730,7,"2.7"
3126000,"FLORESTAL","SUDESTE","MINAS GERAIS","194.2419256",8045,4829,4821,8,"2.7"
3126109,"FORMIGA","SUDESTE","MINAS GERAIS","1501.915349",68248,34705,34680,25,"2.6"
3126208,"FORMOSO","SUDESTE","MINAS GERAIS","3686.004297",7949,3720,3702,18,"2.9"
3126307,"FORTALEZA DE MINAS","SUDESTE","MINAS GERAIS","218.7918941",3477,2071,2067,4,"2.5"
3126406,"FORTUNA DE MINAS","SUDESTE","MINAS GERAIS","198.6650603",3093,1824,1823,1,"2.8"
3126505,"FRANCISCO BADARÓ","SUDESTE","MINAS GERAIS","461.4812388",7366,4200,4197,3,"2.6"
3126604,"FRANCISCO DUMONT","SUDESTE","MINAS GERAIS","1576.1283974",4503,2614,2608,6,"2.7"
3126703,"FRANCISCO SÁ","SUDESTE","MINAS GERAIS","2747.294713",23476,11505,11488,17,"2.9"
3126752,"FRANCISCÓPOLIS","SUDESTE","MINAS GERAIS","717.0867295",5034,2467,2465,2,"2.8"
3126802,"FREI GASPAR","SUDESTE","MINAS GERAIS","626.6720803",5640,2835,2835,0,"2.8"
3126901,"FREI INOCÊNCIO","SUDESTE","MINAS GERAIS","469.5569898",8226,3963,3960,3,"2.7"
3126950,"FREI LAGONEGRO","SUDESTE","MINAS GERAIS","167.4738413",3391,1524,1524,0,"2.8"
3127008,"FRONTEIRA","SUDESTE","MINAS GERAIS","199.9870165",14540,7751,7747,4,"2.7"
3127057,"FRONTEIRA DOS VALES","SUDESTE","MINAS GERAIS","320.7573747",4345,2051,2049,2,"2.9"
3127073,"FRUTA DE LEITE","SUDESTE","MINAS GERAIS","762.836596",4647,2738,2737,1,"2.9"
3127107,"FRUTAL","SUDESTE","MINAS GERAIS","2426.9653163",58588,28235,28214,21,"2.5"
3127206,"FUNILÂNDIA","SUDESTE","MINAS GERAIS","199.796546",4686,3171,3168,3,"2.7"
3127305,"GALILÉIA","SUDESTE","MINAS GERAIS","720.3032738",6222,3521,3518,3,"2.7"
3127339,"GAMELEIRAS","SUDESTE","MINAS GERAIS","1733.2026275",4793,2964,2963,1,"2.7"
3127354,"GLAUCILÂNDIA","SUDESTE","MINAS GERAIS","145.8609551",2928,1702,1702,0,"2.7"
3127370,"GOIABEIRA","SUDESTE","MINAS GERAIS","112.4425697",2830,1626,1625,1,"2.5"
3127388,"GOIANÁ","SUDESTE","MINAS GERAIS","152.038996",4053,2356,2354,2,"2.6"
3127404,"GONÇALVES","SUDESTE","MINAS GERAIS","187.3531175",4727,3354,3282,72,"2.6"
3127503,"GONZAGA","SUDESTE","MINAS GERAIS","209.3475452",5230,2403,2397,6,"2.9"
3127602,"GOUVEIA","SUDESTE","MINAS GERAIS","866.6014387",11331,5341,5334,7,"2.8"
3127701,"GOVERNADOR VALADARES","SUDESTE","MINAS GERAIS","2342.3764013",257171,125248,125166,82,"2.6"
3127800,"GRÃO MOGOL","SUDESTE","MINAS GERAIS","3885.2938887",13901,7214,7182,32,"2.9"
3127909,"GRUPIARA","SUDESTE","MINAS GERAIS","193.141224",1392,777,775,2,"2.5"
3128006,"GUANHÃES","SUDESTE","MINAS GERAIS","1075.1237284",32244,15314,15291,23,"2.7"
3128105,"GUAPÉ","SUDESTE","MINAS GERAIS","934.3446795",13772,7863,7848,15,"2.6"
3128204,"GUARACIABA","SUDESTE","MINAS GERAIS","348.5956302",9753,4875,4872,3,"2.8"
3128253,"GUARACIAMA","SUDESTE","MINAS GERAIS","390.262972",5051,2721,2715,6,"2.7"
3128303,"GUARANÉSIA","SUDESTE","MINAS GERAIS","294.8276142",19150,8582,8573,9,"2.7"
3128402,"GUARANI","SUDESTE","MINAS GERAIS","264.1935002",7714,3914,3911,3,"2.7"
3128501,"GUARARÁ","SUDESTE","MINAS GERAIS","88.6551166",3149,1497,1497,0,"2.7"
3128600,"GUARDA-MOR","SUDESTE","MINAS GERAIS","2068.8075936",6539,3344,3326,18,"2.7"
3128709,"GUAXUPÉ","SUDESTE","MINAS GERAIS","286.3983873",50911,23096,23073,23,"2.7"
3128808,"GUIDOVAL","SUDESTE","MINAS GERAIS","158.3750925",7131,3813,3811,2,"2.6"
3128907,"GUIMARÂNIA","SUDESTE","MINAS GERAIS","366.8329731",8478,3531,3525,6,"2.9"
3129004,"GUIRICEMA","SUDESTE","MINAS GERAIS","293.5778784",7778,4091,4087,4,"2.6"
3129103,"GURINHATÃ","SUDESTE","MINAS GERAIS","1849.1372436",5192,3702,3691,11,"2.4"
3129202,"HELIODORA","SUDESTE","MINAS GERAIS","153.9504106",6134,2927,2919,8,"2.6"
3129301,"IAPU","SUDESTE","MINAS GERAIS","340.9942175",12030,5128,5124,4,"3"
3129400,"IBERTIOGA","SUDESTE","MINAS GERAIS","346.2396745",5198,2491,2484,7,"2.7"
3129509,"IBIÁ","SUDESTE","MINAS GERAIS","2704.1319234",22229,10828,10776,52,"2.6"
3129608,"IBIAÍ","SUDESTE","MINAS GERAIS","874.7597968",6286,3277,3273,4,"2.8"
3129657,"IBIRACATU","SUDESTE","MINAS GERAIS","353.257294",5081,2700,2699,1,"2.9"
3129707,"IBIRACI","SUDESTE","MINAS GERAIS","562.0950748",10948,5938,5934,4,"2.9"
3129806,"IBIRITÉ","SUDESTE","MINAS GERAIS","72.3948015",170537,67182,67169,13,"2.9"
3129905,"IBITIÚRA DE MINAS","SUDESTE","MINAS GERAIS","68.3161833",3365,1674,1673,1,"2.5"
3130002,"IBITURUNA","SUDESTE","MINAS GERAIS","153.1056659",2698,1305,1303,2,"2.8"
3130051,"ICARAÍ DE MINAS","SUDESTE","MINAS GERAIS","625.6643103",10677,4256,4254,2,"3.3"
3130101,"IGARAPÉ","SUDESTE","MINAS GERAIS","110.9420956",45847,22197,22155,42,"2.9"
3130200,"IGARATINGA","SUDESTE","MINAS GERAIS","218.3428097",10830,4942,4937,5,"2.8"
3130309,"IGUATAMA","SUDESTE","MINAS GERAIS","628.1996933",6826,4064,4056,8,"2.5"
3130408,"IJACI","SUDESTE","MINAS GERAIS","105.2455878",7003,3275,3266,9,"3"
3130507,"ILICÍNEA","SUDESTE","MINAS GERAIS","376.3413621",12741,5870,5865,5,"2.8"
3130556,"IMBÉ DE MINAS","SUDESTE","MINAS GERAIS","196.7349656",6986,3466,3464,2,"2.7"
3130606,"INCONFIDENTES","SUDESTE","MINAS GERAIS","149.6109587",7301,3769,3760,9,"2.6"
3130655,"INDAIABIRA","SUDESTE","MINAS GERAIS","1004.1485047",6346,3348,3346,2,"2.9"
3130705,"INDIANÓPOLIS","SUDESTE","MINAS GERAIS","830.0304938",6171,3387,3370,17,"2.7"
3130804,"INGAÍ","SUDESTE","MINAS GERAIS","305.5909519",2580,1377,1371,6,"2.7"
3130903,"INHAPIM","SUDESTE","MINAS GERAIS","858.0244357",22692,11994,11985,9,"2.6"
3131000,"INHAÚMA","SUDESTE","MINAS GERAIS","244.9957259",6239,3359,3352,7,"2.8"
3131109,"INIMUTABA","SUDESTE","MINAS GERAIS","527.059845",7371,4123,4121,2,"2.7"
3131158,"IPABA","SUDESTE","MINAS GERAIS","113.2458763",17136,7312,7310,2,"2.8"
3131208,"IPANEMA","SUDESTE","MINAS GERAIS","456.6408539",19522,9557,9547,10,"2.6"
3131307,"IPATINGA","SUDESTE","MINAS GERAIS","164.8844896",227731,97613,97528,85,"2.7"
3131406,"IPIAÇU","SUDESTE","MINAS GERAIS","466.0198495",3775,1981,1979,2,"2.4"
3131505,"IPUIÚNA","SUDESTE","MINAS GERAIS","298.1951076",9135,4089,4087,2,"2.7"
3131604,"IRAÍ DE MINAS","SUDESTE","MINAS GERAIS","356.2638455",7180,3332,3330,2,"2.9"
3131703,"ITABIRA","SUDESTE","MINAS GERAIS","1253.7035363",113343,49294,49119,175,"2.8"
3131802,"ITABIRINHA","SUDESTE","MINAS GERAIS","209.033836",10362,4870,4863,7,"2.6"
3131901,"ITABIRITO","SUDESTE","MINAS GERAIS","544.0272042",53365,24488,24448,40,"2.9"
3132008,"ITACAMBIRA","SUDESTE","MINAS GERAIS","1788.4452889",4252,2079,2079,0,"2.9"
3132107,"ITACARAMBI","SUDESTE","MINAS GERAIS","1225.2729871",17208,7117,7108,9,"3.2"
3132206,"ITAGUARA","SUDESTE","MINAS GERAIS","410.4678093",13846,7227,7221,6,"2.7"
3132305,"ITAIPÉ","SUDESTE","MINAS GERAIS","480.8293392",10463,4837,4831,6,"3"
3132404,"ITAJUBÁ","SUDESTE","MINAS GERAIS","294.835199",93073,40425,40379,46,"2.7"
3132503,"ITAMARANDIBA","SUDESTE","MINAS GERAIS","2735.5729041",32948,15398,15387,11,"2.8"
3132602,"ITAMARATI DE MINAS","SUDESTE","MINAS GERAIS","94.5684016",3690,1874,1870,4,"2.7"
3132701,"ITAMBACURI","SUDESTE","MINAS GERAIS","1419.2093647",21042,9694,9685,9,"2.8"
3132800,"ITAMBÉ DO MATO DENTRO","SUDESTE","MINAS GERAIS","380.3399834",2142,1537,1522,15,"2.6"
3132909,"ITAMOGI","SUDESTE","MINAS GERAIS","243.7143976",10770,5307,5303,4,"2.7"
3133006,"ITAMONTE","SUDESTE","MINAS GERAIS","431.7918485",14786,7245,7207,38,"2.8"
3133105,"ITANHANDU","SUDESTE","MINAS GERAIS","143.3626629",15236,6636,6624,12,"2.8"
3133204,"ITANHOMI","SUDESTE","MINAS GERAIS","488.8428856",11128,5649,5647,2,"2.6"
3133303,"ITAOBIM","SUDESTE","MINAS GERAIS","679.023712",19151,8653,8631,22,"2.7"
3133402,"ITAPAGIPE","SUDESTE","MINAS GERAIS","1802.4375194",13690,6785,6772,13,"2.5"
3133501,"ITAPECERICA","SUDESTE","MINAS GERAIS","1040.5186826",21046,11401,11392,9,"2.6"
3133600,"ITAPEVA","SUDESTE","MINAS GERAIS","177.3470882",12692,6485,6467,18,"2.8"
3133709,"ITATIAIUÇU","SUDESTE","MINAS GERAIS","295.1450561",12966,7891,7881,10,"2.8"
3133758,"ITAÚ DE MINAS","SUDESTE","MINAS GERAIS","153.4212129",14406,6550,6546,4,"2.7"
3133808,"ITAÚNA","SUDESTE","MINAS GERAIS","495.768569",97669,42902,42862,40,"2.6"
3133907,"ITAVERAVA","SUDESTE","MINAS GERAIS","284.220158",5642,3076,3073,3,"2.8"
3134004,"ITINGA","SUDESTE","MINAS GERAIS","1649.6218663",13745,6191,6179,12,"3"
3134103,"ITUETA","SUDESTE","MINAS GERAIS","452.6758042",6055,2995,2993,2,"2.7"
3134202,"ITUIUTABA","SUDESTE","MINAS GERAIS","2598.0457759",102217,48640,48584,56,"2.5"
3134301,"ITUMIRIM","SUDESTE","MINAS GERAIS","234.8021143",6638,3320,3319,1,"2.8"
3134400,"ITURAMA","SUDESTE","MINAS GERAIS","1404.6626789",38295,17794,17776,18,"2.6"
3134509,"ITUTINGA","SUDESTE","MINAS GERAIS","372.0181328",4217,2525,2517,8,"2.6"
3134608,"JABOTICATUBAS","SUDESTE","MINAS GERAIS","1114.9715155",20406,17732,17691,41,"2.6"
3134707,"JACINTO","SUDESTE","MINAS GERAIS","1393.6090526",11042,5769,5762,7,"2.6"
3134806,"JACUÍ","SUDESTE","MINAS GERAIS","409.2285655",7495,4252,4247,5,"2.6"
3134905,"JACUTINGA","SUDESTE","MINAS GERAIS","347.6668763",25525,12054,12041,13,"2.8"
3135001,"JAGUARAÇU","SUDESTE","MINAS GERAIS","163.7597919",3092,1643,1633,10,"2.8"
3135050,"JAÍBA","SUDESTE","MINAS GERAIS","2635.4666274",37660,15742,15719,23,"3.1"
3135076,"JAMPRUCA","SUDESTE","MINAS GERAIS","517.0952493",4296,2169,2166,3,"2.7"
3135100,"JANAÚBA","SUDESTE","MINAS GERAIS","2181.3189183",70699,29719,29689,30,"2.9"
3135209,"JANUÁRIA","SUDESTE","MINAS GERAIS","6661.5884463",65150,29351,29324,27,"3"
3135308,"JAPARAÍBA","SUDESTE","MINAS GERAIS","172.1407318",4506,2154,2153,1,"2.9"
3135357,"JAPONVAR","SUDESTE","MINAS GERAIS","375.1808808",8127,4156,4154,2,"2.8"
3135407,"JECEABA","SUDESTE","MINAS GERAIS","236.2496347",6197,3174,3170,4,"2.7"
3135456,"JENIPAPO DE MINAS","SUDESTE","MINAS GERAIS","284.4529054",6100,2839,2834,5,"2.9"
3135506,"JEQUERI","SUDESTE","MINAS GERAIS","547.897475",12419,6348,6344,4,"2.8"
3135605,"JEQUITAÍ","SUDESTE","MINAS GERAIS","1268.4427168",6484,3923,3912,11,"2.6"
3135704,"JEQUITIBÁ","SUDESTE","MINAS GERAIS","445.0296788",5883,4292,4282,10,"2.6"
3135803,"JEQUITINHONHA","SUDESTE","MINAS GERAIS","3514.2157264",24007,10611,10599,12,"2.9"
3135902,"JESUÂNIA","SUDESTE","MINAS GERAIS","153.8518763",5138,2586,2583,3,"2.7"
3136009,"JOAÍMA","SUDESTE","MINAS GERAIS","1664.1896009",13888,6216,6211,5,"3"
3136108,"JOANÉSIA","SUDESTE","MINAS GERAIS","233.2919704",4329,2532,2529,3,"2.6"
3136207,"JOÃO MONLEVADE","SUDESTE","MINAS GERAIS","99.1577018",80187,33244,33193,51,"2.7"
3136306,"JOÃO PINHEIRO","SUDESTE","MINAS GERAIS","10727.096761",46801,21891,21814,77,"2.7"
3136405,"JOAQUIM FELÍCIO","SUDESTE","MINAS GERAIS","790.93521",3854,2194,2192,2,"2.6"
3136504,"JORDÂNIA","SUDESTE","MINAS GERAIS","546.7053021",10304,4283,4281,2,"3"
3136520,"JOSÉ GONÇALVES DE MINAS","SUDESTE","MINAS GERAIS","381.3320137",3969,2185,2182,3,"2.9"
3136553,"JOSÉ RAYDAN","SUDESTE","MINAS GERAIS","180.8218767",4268,2109,2109,0,"2.7"
3136579,"JOSENÓPOLIS","SUDESTE","MINAS GERAIS","541.3932322",3630,2005,1998,7,"2.9"
3136603,"NOVA UNIÃO","SUDESTE","MINAS GERAIS","172.131263",5909,3430,3421,9,"2.7"
3136652,"JUATUBA","SUDESTE","MINAS GERAIS","97.016507",30716,15904,15890,14,"2.9"
3136702,"JUIZ DE FORA","SUDESTE","MINAS GERAIS","1435.7488549",540756,267747,267529,218,"2.5"
3136801,"JURAMENTO","SUDESTE","MINAS GERAIS","431.6295695",3768,2272,2268,4,"2.7"
3136900,"JURUAIA","SUDESTE","MINAS GERAIS","220.3527038",11084,5013,5008,5,"2.8"
3136959,"JUVENÍLIA","SUDESTE","MINAS GERAIS","1064.6919748",5789,2762,2758,4,"3.1"
3137007,"LADAINHA","SUDESTE","MINAS GERAIS","866.2895645",14383,6249,6241,8,"3"
3137106,"LAGAMAR","SUDESTE","MINAS GERAIS","1474.5619024",6631,3987,3983,4,"2.4"
3137205,"LAGOA DA PRATA","SUDESTE","MINAS GERAIS","439.9841235",51412,21393,21368,25,"2.8"
3137304,"LAGOA DOS PATOS","SUDESTE","MINAS GERAIS","600.5467729",3313,1902,1901,1,"2.7"
3137403,"LAGOA DOURADA","SUDESTE","MINAS GERAIS","476.6928702",12769,5224,5220,4,"3.1"
3137502,"LAGOA FORMOSA","SUDESTE","MINAS GERAIS","840.9204263",18904,9368,9366,2,"2.7"
3137536,"LAGOA GRANDE","SUDESTE","MINAS GERAIS","1236.3014955",8969,4207,4195,12,"2.6"
3137601,"LAGOA SANTA","SUDESTE","MINAS GERAIS","229.4094253",75145,34724,34696,28,"2.7"
3137700,"LAJINHA","SUDESTE","MINAS GERAIS","431.9202385",20835,9753,9751,2,"2.7"
3137809,"LAMBARI","SUDESTE","MINAS GERAIS","213.1103091",20414,10600,10576,24,"2.7"
3137908,"LAMIM","SUDESTE","MINAS GERAIS","118.6017534",3184,1722,1719,3,"2.7"
3138005,"LARANJAL","SUDESTE","MINAS GERAIS","204.8817072",5963,3274,3273,1,"2.6"
3138104,"LASSANCE","SUDESTE","MINAS GERAIS","3204.2168598",7124,3372,3361,11,"2.8"
3138203,"LAVRAS","SUDESTE","MINAS GERAIS","564.7435469",104761,47213,47161,52,"2.7"
3138302,"LEANDRO FERREIRA","SUDESTE","MINAS GERAIS","352.0051574",3199,1985,1981,4,"2.6"
3138351,"LEME DO PRADO","SUDESTE","MINAS GERAIS","280.0361231",4341,2259,2258,1,"2.8"
3138401,"LEOPOLDINA","SUDESTE","MINAS GERAIS","943.0770489",51145,24359,24327,32,"2.7"
3138500,"LIBERDADE","SUDESTE","MINAS GERAIS","401.3365201",4737,3086,3083,3,"2.6"
3138609,"LIMA DUARTE","SUDESTE","MINAS GERAIS","848.5635639",17221,9930,9894,36,"2.5"
3138625,"LIMEIRA DO OESTE","SUDESTE","MINAS GERAIS","1317.1528084",8687,4006,4002,4,"2.6"
3138658,"LONTRA","SUDESTE","MINAS GERAIS","258.9247986",8790,4357,4355,2,"2.9"
3138674,"LUISBURGO","SUDESTE","MINAS GERAIS","145.4184142",6956,3073,3073,0,"2.8"
3138682,"LUISLÂNDIA","SUDESTE","MINAS GERAIS","411.7143612",6210,2723,2722,1,"3.1"
3138708,"LUMINÁRIAS","SUDESTE","MINAS GERAIS","500.1427748",5586,2855,2849,6,"2.6"
3138807,"LUZ","SUDESTE","MINAS GERAIS","1171.6594754",17875,9222,9209,13,"2.6"
3138906,"MACHACALIS","SUDESTE","MINAS GERAIS","332.3778822",6487,3393,3390,3,"2.7"
3139003,"MACHADO","SUDESTE","MINAS GERAIS","585.9576036",37684,16551,16527,24,"2.9"
3139102,"MADRE DE DEUS DE MINAS","SUDESTE","MINAS GERAIS","492.9087403",5191,2838,2831,7,"2.7"
3139201,"MALACACHETA","SUDESTE","MINAS GERAIS","727.8857722",17516,8553,8545,8,"2.7"
3139250,"MAMONAS","SUDESTE","MINAS GERAIS","284.3652974",5997,3547,3546,1,"2.5"
3139300,"MANGA","SUDESTE","MINAS GERAIS","1950.1842516",18886,8182,8172,10,"3.1"
3139409,"MANHUAÇU","SUDESTE","MINAS GERAIS","628.3182463",91886,40171,40144,27,"2.7"
3139508,"MANHUMIRIM","SUDESTE","MINAS GERAIS","182.8996446",20613,9745,9735,10,"2.7"
3139607,"MANTENA","SUDESTE","MINAS GERAIS","685.2082996",26535,13010,13002,8,"2.6"
3139706,"MARAVILHAS","SUDESTE","MINAS GERAIS","261.6042856",7333,3091,3085,6,"2.9"
3139805,"MAR DE ESPANHA","SUDESTE","MINAS GERAIS","371.5997255",12721,6150,6142,8,"2.7"
3139904,"MARIA DA FÉ","SUDESTE","MINAS GERAIS","202.8977786",14247,5753,5749,4,"3"
3140001,"MARIANA","SUDESTE","MINAS GERAIS","1194.2076493",61387,28717,28477,240,"2.8"
3140100,"MARILAC","SUDESTE","MINAS GERAIS","158.8090715",4224,1942,1940,2,"2.7"
3140159,"MÁRIO CAMPOS","SUDESTE","MINAS GERAIS","35.1964345",15900,7158,7155,3,"2.9"
3140209,"MARIPÁ DE MINAS","SUDESTE","MINAS GERAIS","77.3382924",3387,1544,1542,2,"2.7"
3140308,"MARLIÉRIA","SUDESTE","MINAS GERAIS","545.8127223",4592,2671,2665,6,"2.7"
3140407,"MARMELÓPOLIS","SUDESTE","MINAS GERAIS","107.9015162",3200,1626,1618,8,"2.7"
3140506,"MARTINHO CAMPOS","SUDESTE","MINAS GERAIS","1058.4177906",14003,7988,7978,10,"2.6"
3140530,"MARTINS SOARES","SUDESTE","MINAS GERAIS","113.2678568",8396,3692,3689,3,"2.8"
3140555,"MATA VERDE","SUDESTE","MINAS GERAIS","227.5389101",9112,3417,3413,4,"3.1"
3140605,"MATERLÂNDIA","SUDESTE","MINAS GERAIS","280.53049",3963,2001,1999,2,"2.8"
3140704,"MATEUS LEME","SUDESTE","MINAS GERAIS","301.3826214",37841,20870,20855,15,"2.7"
3140803,"MATIAS BARBOSA","SUDESTE","MINAS GERAIS","157.0664614",14121,6671,6662,9,"2.7"
3140852,"MATIAS CARDOSO","SUDESTE","MINAS GERAIS","1940.5975503",8895,4109,4096,13,"3.1"
3140902,"MATIPÓ","SUDESTE","MINAS GERAIS","266.9903196",18552,8083,8077,6,"3"
3141009,"MATO VERDE","SUDESTE","MINAS GERAIS","472.2453028",12038,6448,6441,7,"2.6"
3141108,"MATOZINHOS","SUDESTE","MINAS GERAIS","252.453392",37618,16236,16224,12,"2.8"
3141207,"MATUTINA","SUDESTE","MINAS GERAIS","260.9573275",3814,2055,2054,1,"2.4"
3141306,"MEDEIROS","SUDESTE","MINAS GERAIS","946.4367869",3900,1917,1904,13,"2.7"
3141405,"MEDINA","SUDESTE","MINAS GERAIS","1435.9034281",20156,9600,9589,11,"2.8"
3141504,"MENDES PIMENTEL","SUDESTE","MINAS GERAIS","305.5074735",5606,2963,2962,1,"2.5"
3141603,"MERCÊS","SUDESTE","MINAS GERAIS","348.2713202",10373,5316,5313,3,"2.5"
3141702,"MESQUITA","SUDESTE","MINAS GERAIS","274.938203",5040,3087,3084,3,"2.7"
3141801,"MINAS NOVAS","SUDESTE","MINAS GERAIS","1812.398035",24405,12464,12448,16,"3"
3141900,"MINDURI","SUDESTE","MINAS GERAIS","219.7739646",3741,1757,1753,4,"2.7"
3142007,"MIRABELA","SUDESTE","MINAS GERAIS","723.2776374",13651,6568,6562,6,"3"
3142106,"MIRADOURO","SUDESTE","MINAS GERAIS","301.6722751",8968,4602,4595,7,"2.5"
3142205,"MIRAÍ","SUDESTE","MINAS GERAIS","320.6954254",13633,6202,6199,3,"2.7"
3142254,"MIRAVÂNIA","SUDESTE","MINAS GERAIS","602.1282266",3985,1922,1920,2,"2.9"
3142304,"MOEDA","SUDESTE","MINAS GERAIS","155.1116194",5125,3131,3124,7,"2.8"
3142403,"MOEMA","SUDESTE","MINAS GERAIS","202.705387",7548,3896,3894,2,"2.7"
3142502,"MONJOLOS","SUDESTE","MINAS GERAIS","650.9110383",2169,1278,1275,3,"2.6"
3142601,"MONSENHOR PAULO","SUDESTE","MINAS GERAIS","216.5402475",8340,4096,4092,4,"2.8"
3142700,"MONTALVÂNIA","SUDESTE","MINAS GERAIS","1503.7549299",14060,6658,6653,5,"2.9"
3142809,"MONTE ALEGRE DE MINAS","SUDESTE","MINAS GERAIS","2595.9566941",20170,10067,10054,13,"2.6"
3142908,"MONTE AZUL","SUDESTE","MINAS GERAIS","1001.2959924",20328,11127,11117,10,"2.6"
3143005,"MONTE BELO","SUDESTE","MINAS GERAIS","421.2830934",13046,6593,6587,6,"2.7"
3143104,"MONTE CARMELO","SUDESTE","MINAS GERAIS","1343.035175",47692,22294,22263,31,"2.6"
3143153,"MONTE FORMOSO","SUDESTE","MINAS GERAIS","385.5527881",4381,2055,2054,1,"3"
3143203,"MONTE SANTO DE MINAS","SUDESTE","MINAS GERAIS","594.6321479",20890,10624,10620,4,"2.6"
3143302,"MONTES CLAROS","SUDESTE","MINAS GERAIS","3589.8109997",414240,180227,180088,139,"2.8"
3143401,"MONTE SIÃO","SUDESTE","MINAS GERAIS","291.5937779",24089,11717,11703,14,"2.6"
3143450,"MONTEZUMA","SUDESTE","MINAS GERAIS","1130.4191495",6888,3480,3469,11,"3"
3143500,"MORADA NOVA DE MINAS","SUDESTE","MINAS GERAIS","2084.27545",9067,5066,5051,15,"2.6"
3143609,"MORRO DA GARÇA","SUDESTE","MINAS GERAIS","414.7715675",2411,1343,1341,2,"2.6"
3143708,"MORRO DO PILAR","SUDESTE","MINAS GERAIS","477.5483531",3133,1868,1864,4,"2.8"
3143807,"MUNHOZ","SUDESTE","MINAS GERAIS","191.5639488",7451,3984,3976,8,"2.8"
3143906,"MURIAÉ","SUDESTE","MINAS GERAIS","841.693014",104108,50591,50560,31,"2.6"
3144003,"MUTUM","SUDESTE","MINAS GERAIS","1250.8235486",27635,13465,13452,13,"2.7"
3144102,"MUZAMBINHO","SUDESTE","MINAS GERAIS","409.9475652",21891,10887,10829,58,"2.7"
3144201,"NACIP RAYDAN","SUDESTE","MINAS GERAIS","233.4930296",2459,1269,1269,0,"2.7"
3144300,"NANUQUE","SUDESTE","MINAS GERAIS","1518.165724",35038,16864,16843,21,"2.6"
3144359,"NAQUE","SUDESTE","MINAS GERAIS","127.1729806",6303,2701,2699,2,"2.9"
3144375,"NATALÂNDIA","SUDESTE","MINAS GERAIS","468.6595948",3520,1674,1672,2,"2.7"
3144409,"NATÉRCIA","SUDESTE","MINAS GERAIS","188.7191795",4691,2370,2368,2,"2.6"
3144508,"NAZARENO","SUDESTE","MINAS GERAIS","341.4526678",8179,4376,4364,12,"2.7"
3144607,"NEPOMUCENO","SUDESTE","MINAS GERAIS","582.5525542",25018,11888,11875,13,"2.8"
3144656,"NINHEIRA","SUDESTE","MINAS GERAIS","1108.2552121",10588,4308,4306,2,"3.2"
3144672,"NOVA BELÉM","SUDESTE","MINAS GERAIS","146.7747409",3151,1734,1733,1,"2.7"
3144706,"NOVA ERA","SUDESTE","MINAS GERAIS","361.9260181",17438,7506,7491,15,"2.8"
3144805,"NOVA LIMA","SUDESTE","MINAS GERAIS","429.3133363",111697,48413,48249,164,"2.8"
3144904,"NOVA MÓDICA","SUDESTE","MINAS GERAIS","375.9726631",3663,1971,1969,2,"2.6"
3145000,"NOVA PONTE","SUDESTE","MINAS GERAIS","1111.0112386",14598,6275,6265,10,"2.9"
3145059,"NOVA PORTEIRINHA","SUDESTE","MINAS GERAIS","120.9434939",6706,3041,3040,1,"3"
3145109,"NOVA RESENDE","SUDESTE","MINAS GERAIS","390.1515988",16387,7873,7862,11,"2.8"
3145208,"NOVA SERRANA","SUDESTE","MINAS GERAIS","282.4716671",105552,42938,42920,18,"2.8"
3145307,"NOVO CRUZEIRO","SUDESTE","MINAS GERAIS","1702.981307",26975,12338,12321,17,"3"
3145356,"NOVO ORIENTE DE MINAS","SUDESTE","MINAS GERAIS","755.1509794",10275,4780,4774,6,"2.8"
3145372,"NOVORIZONTE","SUDESTE","MINAS GERAIS","271.6101624",4571,2507,2506,1,"2.8"
3145406,"OLARIA","SUDESTE","MINAS GERAIS","178.2415555",1945,1188,1187,1,"2.6"
3145455,"OLHOS-D'ÁGUA","SUDESTE","MINAS GERAIS","2092.0778438",5385,2949,2943,6,"2.8"
3145505,"OLÍMPIO NORONHA","SUDESTE","MINAS GERAIS","54.6329825",2555,1304,1304,0,"2.7"
3145604,"OLIVEIRA","SUDESTE","MINAS GERAIS","897.2938751",39262,18389,18367,22,"2.8"
3145703,"OLIVEIRA FORTES","SUDESTE","MINAS GERAIS","111.1300282",2027,1099,1099,0,"2.7"
3145802,"ONÇA DE PITANGUI","SUDESTE","MINAS GERAIS","246.9764571",2969,1919,1918,1,"2.7"
3145851,"ORATÓRIOS","SUDESTE","MINAS GERAIS","89.0677062",4917,2032,2031,1,"3"
3145877,"ORIZÂNIA","SUDESTE","MINAS GERAIS","121.8001391",8437,3701,3699,2,"2.8"
3145901,"OURO BRANCO","SUDESTE","MINAS GERAIS","258.7258304",38724,17221,17180,41,"2.8"
3146008,"OURO FINO","SUDESTE","MINAS GERAIS","533.7135451",32094,16211,16197,14,"2.6"
3146107,"OURO PRETO","SUDESTE","MINAS GERAIS","1245.8651171",74821,37581,37216,365,"2.8"
3146206,"OURO VERDE DE MINAS","SUDESTE","MINAS GERAIS","175.4821147",5757,2523,2518,5,"2.9"
3146255,"PADRE CARVALHO","SUDESTE","MINAS GERAIS","446.2747945",5058,2345,2342,3,"3.1"
3146305,"PADRE PARAÍSO","SUDESTE","MINAS GERAIS","544.3753762",17334,7550,7539,11,"2.9"
3146404,"PAINEIRAS","SUDESTE","MINAS GERAIS","637.3088676",4224,2481,2478,3,"2.4"
3146503,"PAINS","SUDESTE","MINAS GERAIS","421.8622035",8142,3916,3907,9,"2.6"
3146552,"PAI PEDRO","SUDESTE","MINAS GERAIS","839.8051846",5551,2873,2871,2,"2.8"
3146602,"PAIVA","SUDESTE","MINAS GERAIS","58.4186455",1474,802,802,0,"2.5"
3146701,"PALMA","SUDESTE","MINAS GERAIS","316.4761179",5707,2977,2973,4,"2.6"
3146750,"PALMÓPOLIS","SUDESTE","MINAS GERAIS","433.1539099",6301,3146,3143,3,"2.6"
3146909,"PAPAGAIOS","SUDESTE","MINAS GERAIS","553.5766577",13920,5606,5591,15,"2.9"
3147006,"PARACATU","SUDESTE","MINAS GERAIS","8231.0289715",94023,39829,39681,148,"2.9"
3147105,"PARÁ DE MINAS","SUDESTE","MINAS GERAIS","551.2471007",97139,41420,41384,36,"2.7"
3147204,"PARAGUAÇU","SUDESTE","MINAS GERAIS","424.2960466",21723,9819,9814,5,"2.8"
3147303,"PARAISÓPOLIS","SUDESTE","MINAS GERAIS","331.2375616",20445,10605,10554,51,"2.6"
3147402,"PARAOPEBA","SUDESTE","MINAS GERAIS","625.6306686",24107,11127,11111,16,"2.7"
3147501,"PASSABÉM","SUDESTE","MINAS GERAIS","94.1825981",1600,955,954,1,"2.6"
3147600,"PASSA QUATRO","SUDESTE","MINAS GERAIS","277.2206338",15515,7166,7142,24,"2.8"
3147709,"PASSA TEMPO","SUDESTE","MINAS GERAIS","429.1721391",8473,4708,4705,3,"2.6"
3147808,"PASSA VINTE","SUDESTE","MINAS GERAIS","246.5645889",2233,1456,1450,6,"2.5"
3147907,"PASSOS","SUDESTE","MINAS GERAIS","1338.0700331",111939,51183,51146,37,"2.7"
3147956,"PATIS","SUDESTE","MINAS GERAIS","444.1964768",4837,2624,2621,3,"2.9"
3148004,"PATOS DE MINAS","SUDESTE","MINAS GERAIS","3190.4558623",159235,77170,77072,98,"2.6"
3148103,"PATROCÍNIO","SUDESTE","MINAS GERAIS","2874.3442466",89826,38570,38490,80,"2.8"
3148202,"PATROCÍNIO DO MURIAÉ","SUDESTE","MINAS GERAIS","108.2458751",5576,2981,2978,3,"2.5"
3148301,"PAULA CÂNDIDO","SUDESTE","MINAS GERAIS","268.3210469",8659,4347,4344,3,"2.8"
3148400,"PAULISTAS","SUDESTE","MINAS GERAIS","220.5642865",4389,2034,2031,3,"2.9"
3148509,"PAVÃO","SUDESTE","MINAS GERAIS","601.1904903",8047,3602,3598,4,"2.9"
3148608,"PEÇANHA","SUDESTE","MINAS GERAIS","996.645973",17446,7359,7355,4,"3.1"
3148707,"PEDRA AZUL","SUDESTE","MINAS GERAIS","1594.6510431",24410,9188,9176,12,"3.3"
3148756,"PEDRA BONITA","SUDESTE","MINAS GERAIS","173.9279591",7320,2800,2798,2,"3.1"
3148806,"PEDRA DO ANTA","SUDESTE","MINAS GERAIS","173.1678488",3311,1741,1740,1,"2.6"
3148905,"PEDRA DO INDAIÁ","SUDESTE","MINAS GERAIS","347.9200865",4112,2207,2206,1,"2.7"
3149002,"PEDRA DOURADA","SUDESTE","MINAS GERAIS","69.9904353",2757,1283,1280,3,"2.7"
3149101,"PEDRALVA","SUDESTE","MINAS GERAIS","217.9894981",10760,5141,5136,5,"2.8"
3149150,"PEDRAS DE MARIA DA CRUZ","SUDESTE","MINAS GERAIS","1525.648443",10433,5532,5522,10,"3"
3149200,"PEDRINÓPOLIS","SUDESTE","MINAS GERAIS","357.8910127",3344,1806,1800,6,"2.7"
3149309,"PEDRO LEOPOLDO","SUDESTE","MINAS GERAIS","292.8308852",62580,27221,27200,21,"2.8"
3149408,"PEDRO TEIXEIRA","SUDESTE","MINAS GERAIS","112.9591441",1810,1081,1081,0,"2.5"
3149507,"PEQUERI","SUDESTE","MINAS GERAIS","90.8329625",3351,1676,1675,1,"2.6"
3149606,"PEQUI","SUDESTE","MINAS GERAIS","203.9913625",4155,2314,2312,2,"2.7"
3149705,"PERDIGÃO","SUDESTE","MINAS GERAIS","249.3222772",12268,6545,6540,5,"2.7"
3149804,"PERDIZES","SUDESTE","MINAS GERAIS","2451.1117515",17151,8238,8201,37,"2.8"
3149903,"PERDÕES","SUDESTE","MINAS GERAIS","270.6566624",21384,9734,9725,9,"2.7"
3149952,"PERIQUITO","SUDESTE","MINAS GERAIS","228.9074896",6553,3074,3074,0,"2.9"
3150000,"PESCADOR","SUDESTE","MINAS GERAIS","317.4625237",3570,1703,1702,1,"2.7"
3150109,"PIAU","SUDESTE","MINAS GERAIS","192.1958629",2796,1823,1822,1,"2.6"
3150158,"PIEDADE DE CARATINGA","SUDESTE","MINAS GERAIS","109.3446317",8529,4087,4086,1,"2.7"
3150208,"PIEDADE DE PONTE NOVA","SUDESTE","MINAS GERAIS","83.7326302",3976,1597,1595,2,"3"
3150307,"PIEDADE DO RIO GRANDE","SUDESTE","MINAS GERAIS","322.8143147",4604,2820,2817,3,"2.5"
3150406,"PIEDADE DOS GERAIS","SUDESTE","MINAS GERAIS","259.6382599",5019,3311,3309,2,"2.5"
3150505,"PIMENTA","SUDESTE","MINAS GERAIS","414.969398",8563,4650,4641,9,"2.6"
3150539,"PINGO-D'ÁGUA","SUDESTE","MINAS GERAIS","66.5701235",4706,1933,1931,2,"2.9"
3150570,"PINTÓPOLIS","SUDESTE","MINAS GERAIS","1228.7359096",7084,2973,2971,2,"3.1"
3150604,"PIRACEMA","SUDESTE","MINAS GERAIS","280.3353327",6700,4094,4091,3,"2.6"
3150703,"PIRAJUBA","SUDESTE","MINAS GERAIS","337.9796364",5537,2443,2443,0,"2.7"
3150802,"PIRANGA","SUDESTE","MINAS GERAIS","658.8116268",17018,7893,7885,8,"2.9"
3150901,"PIRANGUÇU","SUDESTE","MINAS GERAIS","203.6186929",6041,3079,3074,5,"2.7"
3151008,"PIRANGUINHO","SUDESTE","MINAS GERAIS","124.8034613",9120,4467,4463,4,"2.8"
3151107,"PIRAPETINGA","SUDESTE","MINAS GERAIS","190.680546",11077,5262,5258,4,"2.6"
3151206,"PIRAPORA","SUDESTE","MINAS GERAIS","549.5142961",55606,23417,23381,36,"2.9"
3151305,"PIRAÚBA","SUDESTE","MINAS GERAIS","144.2886218",11610,5529,5523,6,"2.7"
3151404,"PITANGUI","SUDESTE","MINAS GERAIS","569.6357523",26685,12168,12151,17,"2.8"
3151503,"PIUMHI","SUDESTE","MINAS GERAIS","902.4682746",36062,16433,16390,43,"2.6"
3151602,"PLANURA","SUDESTE","MINAS GERAIS","317.5201618",11145,5735,5727,8,"2.7"
3151701,"POÇO FUNDO","SUDESTE","MINAS GERAIS","474.2443698",16390,8122,8118,4,"2.7"
3151800,"POÇOS DE CALDAS","SUDESTE","MINAS GERAIS","546.9578517",163742,79891,79802,89,"2.6"
3151909,"POCRANE","SUDESTE","MINAS GERAIS","691.065544",8350,4524,4520,4,"2.6"
3152006,"POMPÉU","SUDESTE","MINAS GERAIS","2551.0741453",31047,15212,15199,13,"2.8"
3152105,"PONTE NOVA","SUDESTE","MINAS GERAIS","470.642649",57776,25623,25600,23,"2.7"
3152131,"PONTO CHIQUE","SUDESTE","MINAS GERAIS","602.7986288",3747,1874,1871,3,"2.9"
3152170,"PONTO DOS VOLANTES","SUDESTE","MINAS GERAIS","1212.4133959",10883,4779,4776,3,"2.9"
3152204,"PORTEIRINHA","SUDESTE","MINAS GERAIS","1749.683088",37438,17827,17813,14,"2.7"
3152303,"PORTO FIRME","SUDESTE","MINAS GERAIS","284.7773401",10569,4962,4959,3,"2.8"
3152402,"POTÉ","SUDESTE","MINAS GERAIS","625.1110994",13666,6945,6939,6,"2.7"
3152501,"POUSO ALEGRE","SUDESTE","MINAS GERAIS","542.7965365",152217,70859,70782,77,"2.7"
3152600,"POUSO ALTO","SUDESTE","MINAS GERAIS","263.0337386",6566,3383,3371,12,"2.6"
3152709,"PRADOS","SUDESTE","MINAS GERAIS","264.1149405",9048,4599,4585,14,"2.8"
3152808,"PRATA","SUDESTE","MINAS GERAIS","4847.5436363",28342,14581,14552,29,"2.7"
3152907,"PRATÁPOLIS","SUDESTE","MINAS GERAIS","215.5163238",8406,4409,4405,4,"2.5"
3153004,"PRATINHA","SUDESTE","MINAS GERAIS","622.4783138",3559,1927,1925,2,"2.6"
3153103,"PRESIDENTE BERNARDES","SUDESTE","MINAS GERAIS","236.7977114",4850,2588,2586,2,"2.7"
3153202,"PRESIDENTE JUSCELINO","SUDESTE","MINAS GERAIS","695.8822397",3465,2102,2100,2,"2.6"
3153301,"PRESIDENTE KUBITSCHEK","SUDESTE","MINAS GERAIS","189.2348322",3071,1291,1287,4,"3.2"
3153400,"PRESIDENTE OLEGÁRIO","SUDESTE","MINAS GERAIS","3503.8477506",18765,10636,10622,14,"2.5"
3153509,"ALTO JEQUITIBÁ","SUDESTE","MINAS GERAIS","152.2722225",8397,4206,4203,3,"2.6"
3153608,"PRUDENTE DE MORAIS","SUDESTE","MINAS GERAIS","124.1890592",11466,4987,4978,9,"2.9"
3153707,"QUARTEL GERAL","SUDESTE","MINAS GERAIS","556.4356492",3179,2042,2041,1,"2.4"
3153806,"QUELUZITO","SUDESTE","MINAS GERAIS","153.5601874",1770,1090,1090,0,"2.6"
3153905,"RAPOSOS","SUDESTE","MINAS GERAIS","72.2282134",16279,6728,6724,4,"2.9"
3154002,"RAUL SOARES","SUDESTE","MINAS GERAIS","763.3642851",23423,11375,11362,13,"2.6"
3154101,"RECREIO","SUDESTE","MINAS GERAIS","234.2963611",11007,4684,4682,2,"2.8"
3154150,"REDUTO","SUDESTE","MINAS GERAIS","151.8594051",7848,3800,3799,1,"2.8"
3154200,"RESENDE COSTA","SUDESTE","MINAS GERAIS","618.3115197",11230,6146,6136,10,"2.6"
3154309,"RESPLENDOR","SUDESTE","MINAS GERAIS","1081.7957013",17226,8625,8617,8,"2.6"
3154408,"RESSAQUINHA","SUDESTE","MINAS GERAIS","183.0624113",4548,2244,2240,4,"2.8"
3154457,"RIACHINHO","SUDESTE","MINAS GERAIS","1719.2655765",6863,3581,3575,6,"2.7"
3154507,"RIACHO DOS MACHADOS","SUDESTE","MINAS GERAIS","1315.5397066",8756,3687,3683,4,"3.2"
3154606,"RIBEIRÃO DAS NEVES","SUDESTE","MINAS GERAIS","155.1047844",329794,135549,135463,86,"2.9"
3154705,"RIBEIRÃO VERMELHO","SUDESTE","MINAS GERAIS","49.2514744",4080,1907,1901,6,"2.8"
3154804,"RIO ACIMA","SUDESTE","MINAS GERAIS","228.3940582",10261,5479,5469,10,"2.8"
3154903,"RIO CASCA","SUDESTE","MINAS GERAIS","384.3810123",12789,6046,6032,14,"2.7"
3155009,"RIO DOCE","SUDESTE","MINAS GERAIS","112.0936007",2484,1293,1291,2,"2.7"
3155108,"RIO DO PRADO","SUDESTE","MINAS GERAIS","479.8150117",4639,2306,2304,2,"2.7"
3155207,"RIO ESPERA","SUDESTE","MINAS GERAIS","238.6022831",5429,3198,3194,4,"2.6"
3155306,"RIO MANSO","SUDESTE","MINAS GERAIS","231.5400546",5568,3797,3795,2,"2.6"
3155405,"RIO NOVO","SUDESTE","MINAS GERAIS","209.3101436",8518,4141,4136,5,"2.7"
3155504,"RIO PARANAÍBA","SUDESTE","MINAS GERAIS","1352.3532121",14532,7680,7663,17,"2.6"
3155603,"RIO PARDO DE MINAS","SUDESTE","MINAS GERAIS","3117.6749236",28271,13099,13089,10,"3"
3155702,"RIO PIRACICABA","SUDESTE","MINAS GERAIS","373.0370201",14631,6684,6671,13,"2.8"
3155801,"RIO POMBA","SUDESTE","MINAS GERAIS","252.4177538",17443,8766,8758,8,"2.6"
3155900,"RIO PRETO","SUDESTE","MINAS GERAIS","348.0463391",5141,3065,3049,16,"2.5"
3156007,"RIO VERMELHO","SUDESTE","MINAS GERAIS","986.5613305",12641,6137,6130,7,"2.9"
3156106,"RITÁPOLIS","SUDESTE","MINAS GERAIS","404.8045241",4994,2942,2941,1,"2.5"
3156205,"ROCHEDO DE MINAS","SUDESTE","MINAS GERAIS","79.4022044",2291,1123,1122,1,"2.7"
3156304,"RODEIRO","SUDESTE","MINAS GERAIS","72.6731749",8664,3533,3530,3,"2.8"
3156403,"ROMARIA","SUDESTE","MINAS GERAIS","407.5568785",3386,1786,1782,4,"2.8"
3156452,"ROSÁRIO DA LIMEIRA","SUDESTE","MINAS GERAIS","111.1555054",4734,2413,2412,1,"2.5"
3156502,"RUBELITA","SUDESTE","MINAS GERAIS","1110.2945435",5679,3415,3410,5,"2.7"
3156601,"RUBIM","SUDESTE","MINAS GERAIS","965.1739527",10298,4415,4411,4,"3"
3156700,"SABARÁ","SUDESTE","MINAS GERAIS","302.452828",129380,55987,55960,27,"2.8"
3156809,"SABINÓPOLIS","SUDESTE","MINAS GERAIS","919.810786",14240,6828,6818,10,"2.7"
3156908,"SACRAMENTO","SUDESTE","MINAS GERAIS","3073.2677112",26670,12968,12933,35,"2.7"
3157005,"SALINAS","SUDESTE","MINAS GERAIS","1862.1170098",40178,20043,20013,30,"2.7"
3157104,"SALTO DA DIVISA","SUDESTE","MINAS GERAIS","938.0081525",6110,2615,2609,6,"2.9"
3157203,"SANTA BÁRBARA","SUDESTE","MINAS GERAIS","684.5053168",30466,13214,13166,48,"2.9"
3157252,"SANTA BÁRBARA DO LESTE","SUDESTE","MINAS GERAIS","107.4021688",8458,3776,3774,2,"2.8"
3157278,"SANTA BÁRBARA DO MONTE VERDE","SUDESTE","MINAS GERAIS","417.9245843",3095,2138,2137,1,"2.6"
3157302,"SANTA BÁRBARA DO TUGÚRIO","SUDESTE","MINAS GERAIS","194.5644731",4208,2189,2189,0,"2.7"
3157336,"SANTA CRUZ DE MINAS","SUDESTE","MINAS GERAIS","3.5650989",8109,3403,3398,5,"2.8"
3157377,"SANTA CRUZ DE SALINAS","SUDESTE","MINAS GERAIS","589.6072966",3910,2325,2321,4,"2.7"
3157401,"SANTA CRUZ DO ESCALVADO","SUDESTE","MINAS GERAIS","258.7258707",4673,2441,2441,0,"2.7"
3157500,"SANTA EFIGÊNIA DE MINAS","SUDESTE","MINAS GERAIS","131.9653685",4039,1992,1991,1,"2.7"
3157609,"SANTA FÉ DE MINAS","SUDESTE","MINAS GERAIS","2917.448497",3522,1981,1977,4,"2.8"
3157658,"SANTA HELENA DE MINAS","SUDESTE","MINAS GERAIS","276.4325564",5938,2504,2503,1,"3.1"
3157708,"SANTA JULIANA","SUDESTE","MINAS GERAIS","723.7835598",15734,6247,6216,31,"2.9"
3157807,"SANTA LUZIA","SUDESTE","MINAS GERAIS","235.2048626",219132,90310,90279,31,"2.9"
3157906,"SANTA MARGARIDA","SUDESTE","MINAS GERAIS","255.7302417",16395,6634,6630,4,"2.9"
3158003,"SANTA MARIA DE ITABIRA","SUDESTE","MINAS GERAIS","597.4409706",10485,4727,4721,6,"3"
3158102,"SANTA MARIA DO SALTO","SUDESTE","MINAS GERAIS","440.6050086",4755,2464,2462,2,"2.7"
3158201,"SANTA MARIA DO SUAÇUÍ","SUDESTE","MINAS GERAIS","624.0474421",12788,6279,6269,10,"2.8"
3158300,"SANTANA DA VARGEM","SUDESTE","MINAS GERAIS","172.4435912",6691,3044,3040,4,"2.8"
3158409,"SANTANA DE CATAGUASES","SUDESTE","MINAS GERAIS","161.4863126",3489,1854,1853,1,"2.6"
3158508,"SANTANA DE PIRAPAMA","SUDESTE","MINAS GERAIS","1255.8315576",7030,4671,4669,2,"2.5"
3158607,"SANTANA DO DESERTO","SUDESTE","MINAS GERAIS","182.6547087",3747,1874,1872,2,"2.8"
3158706,"SANTANA DO GARAMBÉU","SUDESTE","MINAS GERAIS","203.0744065",2137,1166,1162,4,"2.7"
3158805,"SANTANA DO JACARÉ","SUDESTE","MINAS GERAIS","106.1692352",4214,2104,2101,3,"2.6"
3158904,"SANTANA DO MANHUAÇU","SUDESTE","MINAS GERAIS","347.362109",8987,3974,3972,2,"2.8"
3158953,"SANTANA DO PARAÍSO","SUDESTE","MINAS GERAIS","276.0669671",44800,20228,20217,11,"2.7"
3159001,"SANTANA DO RIACHO","SUDESTE","MINAS GERAIS","677.2065982",5313,3649,3637,12,"2.7"
3159100,"SANTANA DOS MONTES","SUDESTE","MINAS GERAIS","196.5647602",3469,2040,2033,7,"2.7"
3159209,"SANTA RITA DE CALDAS","SUDESTE","MINAS GERAIS","503.0113721",8460,4618,4613,5,"2.5"
3159308,"SANTA RITA DE JACUTINGA","SUDESTE","MINAS GERAIS","420.9402286",4755,3147,3135,12,"2.5"
3159357,"SANTA RITA DE MINAS","SUDESTE","MINAS GERAIS","68.1527526",6773,3297,3296,1,"2.7"
3159407,"SANTA RITA DE IBITIPOCA","SUDESTE","MINAS GERAIS","324.2337215",3301,1926,1926,0,"2.7"
3159506,"SANTA RITA DO ITUETO","SUDESTE","MINAS GERAIS","485.0814249",5826,3082,3077,5,"2.6"
3159605,"SANTA RITA DO SAPUCAÍ","SUDESTE","MINAS GERAIS","352.9691567",40635,17742,17718,24,"2.9"
3159704,"SANTA ROSA DA SERRA","SUDESTE","MINAS GERAIS","284.3338281",3382,1739,1738,1,"2.8"
3159803,"SANTA VITÓRIA","SUDESTE","MINAS GERAIS","2998.3643263",20973,11139,11123,16,"2.5"
3159902,"SANTO ANTÔNIO DO AMPARO","SUDESTE","MINAS GERAIS","488.8845291",17285,7429,7423,6,"2.9"
3160009,"SANTO ANTÔNIO DO AVENTUREIRO","SUDESTE","MINAS GERAIS","202.0318554",3769,1937,1935,2,"2.6"
3160108,"SANTO ANTÔNIO DO GRAMA","SUDESTE","MINAS GERAIS","130.2126069",4229,1851,1847,4,"2.8"
3160207,"SANTO ANTÔNIO DO ITAMBÉ","SUDESTE","MINAS GERAIS","305.7367334",3915,1875,1874,1,"2.9"
3160306,"SANTO ANTÔNIO DO JACINTO","SUDESTE","MINAS GERAIS","503.7064662",10327,4942,4941,1,"2.7"
3160405,"SANTO ANTÔNIO DO MONTE","SUDESTE","MINAS GERAIS","1125.779603",27295,13700,13692,8,"2.7"
3160454,"SANTO ANTÔNIO DO RETIRO","SUDESTE","MINAS GERAIS","796.2900282",6629,3242,3239,3,"3"
3160504,"SANTO ANTÔNIO DO RIO ABAIXO","SUDESTE","MINAS GERAIS","107.2690947",1808,1033,1030,3,"2.8"
3160603,"SANTO HIPÓLITO","SUDESTE","MINAS GERAIS","430.6564064",2717,1790,1787,3,"2.4"
3160702,"SANTOS DUMONT","SUDESTE","MINAS GERAIS","637.3733078",42406,20585,20570,15,"2.7"
3160801,"SÃO BENTO ABADE","SUDESTE","MINAS GERAIS","80.4033447",4713,1835,1834,1,"2.9"
3160900,"SÃO BRÁS DO SUAÇUÍ","SUDESTE","MINAS GERAIS","110.0185298",3989,2234,2225,9,"2.7"
3160959,"SÃO DOMINGOS DAS DORES","SUDESTE","MINAS GERAIS","60.8653784",5626,2503,2502,1,"2.9"
3161007,"SÃO DOMINGOS DO PRATA","SUDESTE","MINAS GERAIS","743.7679515",17392,9123,9108,15,"2.6"
3161056,"SÃO FÉLIX DE MINAS","SUDESTE","MINAS GERAIS","162.5600555",3200,1627,1627,0,"2.6"
3161106,"SÃO FRANCISCO","SUDESTE","MINAS GERAIS","3308.0999369",52762,21607,21593,14,"3.2"
3161205,"SÃO FRANCISCO DE PAULA","SUDESTE","MINAS GERAIS","316.8224726",6187,3153,3149,4,"2.7"
3161304,"SÃO FRANCISCO DE SALES","SUDESTE","MINAS GERAIS","1128.8639246",5732,3051,3051,0,"2.5"
3161403,"SÃO FRANCISCO DO GLÓRIA","SUDESTE","MINAS GERAIS","164.6132145",4800,2381,2374,7,"2.7"
3161502,"SÃO GERALDO","SUDESTE","MINAS GERAIS","185.5780921",10282,4984,4981,3,"2.6"
3161601,"SÃO GERALDO DA PIEDADE","SUDESTE","MINAS GERAIS","152.3358905",3305,1625,1625,0,"2.6"
3161650,"SÃO GERALDO DO BAIXIO","SUDESTE","MINAS GERAIS","280.9544717",3143,1781,1779,2,"2.5"
3161700,"SÃO GONÇALO DO ABAETÉ","SUDESTE","MINAS GERAIS","2692.5446816",7375,4493,4429,64,"2.7"
3161809,"SÃO GONÇALO DO PARÁ","SUDESTE","MINAS GERAIS","265.7298033",11770,6350,6346,4,"2.7"
3161908,"SÃO GONÇALO DO RIO ABAIXO","SUDESTE","MINAS GERAIS","363.8275978",11850,5741,5724,17,"3"
3162005,"SÃO GONÇALO DO SAPUCAÍ","SUDESTE","MINAS GERAIS","516.6832943",23959,10623,10606,17,"2.9"
3162104,"SÃO GOTARDO","SUDESTE","MINAS GERAIS","866.0870523",40910,17117,17091,26,"2.8"
3162203,"SÃO JOÃO BATISTA DO GLÓRIA","SUDESTE","MINAS GERAIS","547.9077097",7652,3897,3840,57,"2.7"
3162252,"SÃO JOÃO DA LAGOA","SUDESTE","MINAS GERAIS","998.0146446",4822,3129,3128,1,"2.6"
3162302,"SÃO JOÃO DA MATA","SUDESTE","MINAS GERAIS","120.5357022",2914,1568,1567,1,"2.5"
3162401,"SÃO JOÃO DA PONTE","SUDESTE","MINAS GERAIS","1851.1021201",23930,11040,11009,31,"3"
3162450,"SÃO JOÃO DAS MISSÕES","SUDESTE","MINAS GERAIS","678.2743214",13024,4596,4593,3,"3.6"
3162500,"SÃO JOÃO DEL REI","SUDESTE","MINAS GERAIS","1452.0024306",90225,45678,45605,73,"2.6"
3162559,"SÃO JOÃO DO MANHUAÇU","SUDESTE","MINAS GERAIS","143.0956035",11246,4631,4629,2,"2.9"
3162575,"SÃO JOÃO DO MANTENINHA","SUDESTE","MINAS GERAIS","137.9275453",5331,2878,2877,1,"2.5"
3162609,"SÃO JOÃO DO ORIENTE","SUDESTE","MINAS GERAIS","120.1223746",7070,3746,3743,3,"2.5"
3162658,"SÃO JOÃO DO PACUÍ","SUDESTE","MINAS GERAIS","415.9217197",3972,1996,1996,0,"2.8"
3162708,"SÃO JOÃO DO PARAÍSO","SUDESTE","MINAS GERAIS","1925.5753038",23910,9948,9939,9,"3.1"
3162807,"SÃO JOÃO EVANGELISTA","SUDESTE","MINAS GERAIS","478.1831562",15315,7660,7645,15,"2.7"
3162906,"SÃO JOÃO NEPOMUCENO","SUDESTE","MINAS GERAIS","407.4271258",25565,13101,13094,7,"2.6"
3162922,"SÃO JOAQUIM DE BICAS","SUDESTE","MINAS GERAIS","71.7582633",34348,15400,15381,19,"2.9"
3162948,"SÃO JOSÉ DA BARRA","SUDESTE","MINAS GERAIS","308.3189497",7793,4197,4180,17,"2.8"
3162955,"SÃO JOSÉ DA LAPA","SUDESTE","MINAS GERAIS","47.9295096",26090,10807,10801,6,"2.9"
3163003,"SÃO JOSÉ DA SAFIRA","SUDESTE","MINAS GERAIS","213.8808092",3806,1732,1730,2,"2.9"
3163102,"SÃO JOSÉ DA VARGINHA","SUDESTE","MINAS GERAIS","205.5008196",4536,2497,2496,1,"2.6"
3163201,"SÃO JOSÉ DO ALEGRE","SUDESTE","MINAS GERAIS","88.7937162",4133,2012,2012,0,"2.7"
3163300,"SÃO JOSÉ DO DIVINO","SUDESTE","MINAS GERAIS","328.7038739",3464,1879,1877,2,"2.7"
3163409,"SÃO JOSÉ DO GOIABAL","SUDESTE","MINAS GERAIS","189.5778355",5396,2537,2531,6,"2.7"
3163508,"SÃO JOSÉ DO JACURI","SUDESTE","MINAS GERAIS","345.145736",6197,2931,2930,1,"2.8"
3163607,"SÃO JOSÉ DO MANTIMENTO","SUDESTE","MINAS GERAIS","54.7009311",2753,1311,1309,2,"2.7"
3163706,"SÃO LOURENÇO","SUDESTE","MINAS GERAIS","58.0186667",44798,22452,22369,83,"2.6"
3163805,"SÃO MIGUEL DO ANTA","SUDESTE","MINAS GERAIS","152.1106854",6334,3000,2996,4,"2.8"
3163904,"SÃO PEDRO DA UNIÃO","SUDESTE","MINAS GERAIS","260.8272716",4885,2873,2870,3,"2.5"
3164001,"SÃO PEDRO DOS FERROS","SUDESTE","MINAS GERAIS","402.7392212",7166,3328,3323,5,"2.7"
3164100,"SÃO PEDRO DO SUAÇUÍ","SUDESTE","MINAS GERAIS","308.1058536",5103,2412,2407,5,"2.7"
3164209,"SÃO ROMÃO","SUDESTE","MINAS GERAIS","2434.0039966",10315,3627,3623,4,"3.5"
3164308,"SÃO ROQUE DE MINAS","SUDESTE","MINAS GERAIS","2098.8666696",7129,4091,4064,27,"2.6"
3164407,"SÃO SEBASTIÃO DA BELA VISTA","SUDESTE","MINAS GERAIS","167.4282975",6387,3400,3395,5,"2.8"
3164431,"SÃO SEBASTIÃO DA VARGEM ALEGRE","SUDESTE","MINAS GERAIS","73.6290033",3113,1570,1569,1,"2.6"
3164472,"SÃO SEBASTIÃO DO ANTA","SUDESTE","MINAS GERAIS","80.6176882",6194,3040,3040,0,"2.7"
3164506,"SÃO SEBASTIÃO DO MARANHÃO","SUDESTE","MINAS GERAIS","517.8297226",10079,4329,4327,2,"3"
3164605,"SÃO SEBASTIÃO DO OESTE","SUDESTE","MINAS GERAIS","408.0900399",8815,5060,5054,6,"2.8"
3164704,"SÃO SEBASTIÃO DO PARAÍSO","SUDESTE","MINAS GERAIS","814.9251667",71796,31687,31654,33,"2.7"
3164803,"SÃO SEBASTIÃO DO RIO PRETO","SUDESTE","MINAS GERAIS","128.0018942",1259,860,856,4,"2.7"
3164902,"SÃO SEBASTIÃO DO RIO VERDE","SUDESTE","MINAS GERAIS","90.8475915",2300,1252,1248,4,"2.6"
3165008,"SÃO TIAGO","SUDESTE","MINAS GERAIS","572.3998894",11192,5769,5761,8,"2.7"
3165107,"SÃO TOMÁS DE AQUINO","SUDESTE","MINAS GERAIS","277.9279178",6740,3199,3196,3,"2.8"
3165206,"SÃO TOMÉ DAS LETRAS","SUDESTE","MINAS GERAIS","369.7474068",6904,4368,4234,134,"2.4"
3165305,"SÃO VICENTE DE MINAS","SUDESTE","MINAS GERAIS","392.6510477",6804,3272,3248,24,"2.7"
3165404,"SAPUCAÍ-MIRIM","SUDESTE","MINAS GERAIS","285.0725421",6311,3756,3722,34,"2.7"
3165503,"SARDOÁ","SUDESTE","MINAS GERAIS","141.9037278",5104,2475,2472,3,"2.7"
3165537,"SARZEDO","SUDESTE","MINAS GERAIS","62.1342725",36844,15183,15179,4,"2.9"
3165552,"SETUBINHA","SUDESTE","MINAS GERAIS","534.6550698",9917,4034,4031,3,"3.3"
3165560,"SEM-PEIXE","SUDESTE","MINAS GERAIS","176.6340614",2433,1357,1356,1,"2.5"
3165578,"SENADOR AMARAL","SUDESTE","MINAS GERAIS","151.0974326",6206,2666,2665,1,"3"
3165602,"SENADOR CORTES","SUDESTE","MINAS GERAIS","98.3358142",2240,1021,1020,1,"2.8"
3165701,"SENADOR FIRMINO","SUDESTE","MINAS GERAIS","166.4951081",7716,4032,4027,5,"2.6"
3165800,"SENADOR JOSÉ BENTO","SUDESTE","MINAS GERAIS","93.8923969",2068,1049,1049,0,"2.6"
3165909,"SENADOR MODESTINO GONÇALVES","SUDESTE","MINAS GERAIS","952.0550095",4008,2258,2256,2,"2.7"
3166006,"SENHORA DE OLIVEIRA","SUDESTE","MINAS GERAIS","170.7488717",5483,2762,2758,4,"2.7"
3166105,"SENHORA DO PORTO","SUDESTE","MINAS GERAIS","381.3280217",3067,1569,1567,2,"2.7"
3166204,"SENHORA DOS REMÉDIOS","SUDESTE","MINAS GERAIS","237.8145131",10384,4835,4833,2,"2.8"
3166303,"SERICITA","SUDESTE","MINAS GERAIS","166.0117621",7345,3175,3175,0,"2.8"
3166402,"SERITINGA","SUDESTE","MINAS GERAIS","114.7692901",1819,931,931,0,"2.6"
3166501,"SERRA AZUL DE MINAS","SUDESTE","MINAS GERAIS","218.5947219",3792,1741,1740,1,"3"
3166600,"SERRA DA SAUDADE","SUDESTE","MINAS GERAIS","335.6589546",833,576,576,0,"2.5"
3166709,"SERRA DOS AIMORÉS","SUDESTE","MINAS GERAIS","213.5744501",6944,3436,3432,4,"2.6"
3166808,"SERRA DO SALITRE","SUDESTE","MINAS GERAIS","1295.2720261",11801,5322,5282,40,"2.9"
3166907,"SERRANIA","SUDESTE","MINAS GERAIS","209.2696611",7621,3433,3420,13,"2.8"
3166956,"SERRANÓPOLIS DE MINAS","SUDESTE","MINAS GERAIS","551.954076",4399,2062,2056,6,"2.9"
3167004,"SERRANOS","SUDESTE","MINAS GERAIS","213.1726664",1990,1100,1096,4,"2.6"
3167103,"SERRO","SUDESTE","MINAS GERAIS","1217.8132195",21952,10198,10162,36,"3"
3167202,"SETE LAGOAS","SUDESTE","MINAS GERAIS","536.9284964",227397,97409,97301,108,"2.8"
3167301,"SILVEIRÂNIA","SUDESTE","MINAS GERAIS","157.456333",2323,1233,1229,4,"2.6"
3167400,"SILVIANÓPOLIS","SUDESTE","MINAS GERAIS","312.1663204",6179,3436,3432,4,"2.5"
3167509,"SIMÃO PEREIRA","SUDESTE","MINAS GERAIS","135.6891232",2947,1672,1672,0,"2.7"
3167608,"SIMONÉSIA","SUDESTE","MINAS GERAIS","486.5426409",19750,8993,8984,9,"2.8"
3167707,"SOBRÁLIA","SUDESTE","MINAS GERAIS","206.786563",5137,2736,2735,1,"2.6"
3167806,"SOLEDADE DE MINAS","SUDESTE","MINAS GERAIS","196.8656764",5613,3060,3052,8,"2.6"
3167905,"TABULEIRO","SUDESTE","MINAS GERAIS","211.0841781",4014,2268,2268,0,"2.6"
3168002,"TAIOBEIRAS","SUDESTE","MINAS GERAIS","1220.0454978",33050,14456,14442,14,"2.8"
3168051,"TAPARUBA","SUDESTE","MINAS GERAIS","193.0816094",3387,1807,1806,1,"2.6"
3168101,"TAPIRA","SUDESTE","MINAS GERAIS","1179.2478599",4118,2193,2157,36,"2.9"
3168200,"TAPIRAÍ","SUDESTE","MINAS GERAIS","407.9195431",1690,1085,1083,2,"2.6"
3168309,"TAQUARAÇU DE MINAS","SUDESTE","MINAS GERAIS","329.2866242",4224,3801,3798,3,"2.6"
3168408,"TARUMIRIM","SUDESTE","MINAS GERAIS","731.7532816",14709,6897,6891,6,"2.8"
3168507,"TEIXEIRAS","SUDESTE","MINAS GERAIS","166.7354633",12255,5943,5941,2,"2.6"
3168606,"TEÓFILO OTONI","SUDESTE","MINAS GERAIS","3242.2695543",137418,60684,60613,71,"2.7"
3168705,"TIMÓTEO","SUDESTE","MINAS GERAIS","144.3812313",81579,33133,33121,12,"2.7"
3168804,"TIRADENTES","SUDESTE","MINAS GERAIS","83.0474691",7744,4526,4303,223,"2.7"
3168903,"TIROS","SUDESTE","MINAS GERAIS","2091.7735922",7883,4355,4349,6,"2.5"
3169000,"TOCANTINS","SUDESTE","MINAS GERAIS","173.8658081",16185,7579,7569,10,"2.6"
3169059,"TOCOS DO MOJI","SUDESTE","MINAS GERAIS","114.704788",3826,1894,1889,5,"2.6"
3169109,"TOLEDO","SUDESTE","MINAS GERAIS","136.7763175",7214,3780,3778,2,"2.8"
3169208,"TOMBOS","SUDESTE","MINAS GERAIS","285.1238181",8609,4357,4353,4,"2.6"
3169307,"TRÊS CORAÇÕES","SUDESTE","MINAS GERAIS","828.0380753",75485,32109,32080,29,"2.8"
3169356,"TRÊS MARIAS","SUDESTE","MINAS GERAIS","2678.2535028",28895,15121,15085,36,"2.7"
3169406,"TRÊS PONTAS","SUDESTE","MINAS GERAIS","689.7939904",55255,23885,23865,20,"2.9"
3169505,"TUMIRITINGA","SUDESTE","MINAS GERAIS","500.0727009",5886,3075,3070,5,"2.6"
3169604,"TUPACIGUARA","SUDESTE","MINAS GERAIS","1822.5295473",25470,12258,12236,22,"2.6"
3169703,"TURMALINA","SUDESTE","MINAS GERAIS","1153.110671",20000,10620,10607,13,"2.7"
3169802,"TURVOLÂNDIA","SUDESTE","MINAS GERAIS","221.0000196",4935,2650,2649,1,"2.7"
3169901,"UBÁ","SUDESTE","MINAS GERAIS","407.4523057",103365,47481,47441,40,"2.6"
3170008,"UBAÍ","SUDESTE","MINAS GERAIS","820.5241154",11708,5034,5031,3,"3.2"
3170057,"UBAPORANGA","SUDESTE","MINAS GERAIS","189.0451397",13017,6046,6045,1,"2.8"
3170107,"UBERABA","SUDESTE","MINAS GERAIS","4523.9571035",337836,152552,152200,352,"2.6"
3170206,"UBERLÂNDIA","SUDESTE","MINAS GERAIS","4115.2061614",713224,336870,336554,316,"2.7"
3170305,"UMBURATIBA","SUDESTE","MINAS GERAIS","405.8335626",2684,1334,1330,4,"2.6"
3170404,"UNAÍ","SUDESTE","MINAS GERAIS","8445.43231",86619,39753,39623,130,"2.7"
3170438,"UNIÃO DE MINAS","SUDESTE","MINAS GERAIS","1147.4065996",3828,2051,2048,3,"2.5"
3170479,"URUANA DE MINAS","SUDESTE","MINAS GERAIS","598.2209676",3282,1746,1743,3,"2.6"
3170503,"URUCÂNIA","SUDESTE","MINAS GERAIS","138.7920326",10600,4157,4153,4,"3"
3170529,"URUCUIA","SUDESTE","MINAS GERAIS","2076.9422752",17479,4691,4686,5,"4.2"
3170578,"VARGEM ALEGRE","SUDESTE","MINAS GERAIS","116.6639897",5780,2949,2946,3,"2.6"
3170602,"VARGEM BONITA","SUDESTE","MINAS GERAIS","409.8876952",2158,1403,1390,13,"2.5"
3170651,"VARGEM GRANDE DO RIO PARDO","SUDESTE","MINAS GERAIS","491.5123989",4633,1931,1926,5,"3.3"
3170701,"VARGINHA","SUDESTE","MINAS GERAIS","395.3960336",136467,60249,60191,58,"2.7"
3170750,"VARJÃO DE MINAS","SUDESTE","MINAS GERAIS","651.5050038",6969,3083,3080,3,"2.8"
3170800,"VÁRZEA DA PALMA","SUDESTE","MINAS GERAIS","2220.2788091",33744,15975,15951,24,"2.6"
3170909,"VARZELÂNDIA","SUDESTE","MINAS GERAIS","814.9941549",18840,9043,9040,3,"3"
3171006,"VAZANTE","SUDESTE","MINAS GERAIS","1913.3962949",19975,9660,9619,41,"2.6"
3171030,"VERDELÂNDIA","SUDESTE","MINAS GERAIS","1570.5819982",7672,3661,3656,5,"3"
3171071,"VEREDINHA","SUDESTE","MINAS GERAIS","631.6914995",5181,3204,3202,2,"2.7"
3171105,"VERÍSSIMO","SUDESTE","MINAS GERAIS","1031.8234842",3411,2144,2137,7,"2.5"
3171154,"VERMELHO NOVO","SUDESTE","MINAS GERAIS","115.241835",4899,2216,2214,2,"2.7"
3171204,"VESPASIANO","SUDESTE","MINAS GERAIS","71.0397294",129246,53169,53129,40,"2.8"
3171303,"VIÇOSA","SUDESTE","MINAS GERAIS","299.417884",76430,40375,40334,41,"2.6"
3171402,"VIEIRAS","SUDESTE","MINAS GERAIS","112.6914457",3700,1851,1850,1,"2.6"
3171501,"MATHIAS LOBATO","SUDESTE","MINAS GERAIS","172.2967269",3038,1433,1432,1,"2.8"
3171600,"VIRGEM DA LAPA","SUDESTE","MINAS GERAIS","868.9142422",11804,6198,6191,7,"2.7"
3171709,"VIRGÍNIA","SUDESTE","MINAS GERAIS","326.5148392",8908,4577,4570,7,"2.7"
3171808,"VIRGINÓPOLIS","SUDESTE","MINAS GERAIS","439.8780578",10314,4850,4844,6,"2.7"
3171907,"VIRGOLÂNDIA","SUDESTE","MINAS GERAIS","281.0223793",4552,2530,2528,2,"2.5"
3172004,"VISCONDE DO RIO BRANCO","SUDESTE","MINAS GERAIS","243.3507987",39160,17931,17922,9,"2.6"
3172103,"VOLTA GRANDE","SUDESTE","MINAS GERAIS","205.551789",4443,2380,2377,3,"2.7"
3172202,"WENCESLAU BRAZ","SUDESTE","MINAS GERAIS","102.4873436",2356,1251,1250,1,"2.7"
3200102,"AFONSO CLÁUDIO","SUDESTE","ESPÍRITO SANTO","941.1880486",30684,14358,14331,27,"2.7"
3200136,"ÁGUIA BRANCA","SUDESTE","ESPÍRITO SANTO","454.4478961",9711,4580,4577,3,"2.7"
3200169,"ÁGUA DOCE DO NORTE","SUDESTE","ESPÍRITO SANTO","473.7290156",12042,6168,6163,5,"2.6"
3200201,"ALEGRE","SUDESTE","ESPÍRITO SANTO","756.8598524",29177,15490,15474,16,"2.6"
3200300,"ALFREDO CHAVES","SUDESTE","ESPÍRITO SANTO","615.6771374",13836,7673,7665,8,"2.7"
3200359,"ALTO RIO NOVO","SUDESTE","ESPÍRITO SANTO","227.6167611",7434,3709,3706,3,"2.6"
3200409,"ANCHIETA","SUDESTE","ESPÍRITO SANTO","409.6913844",29984,16998,16915,83,"2.7"
3200508,"APIACÁ","SUDESTE","ESPÍRITO SANTO","193.9839321",7223,3710,3709,1,"2.6"
3200607,"ARACRUZ","SUDESTE","ESPÍRITO SANTO","1420.2851833",94765,42008,41909,99,"2.9"
3200706,"ATÍLIO VIVÁCQUA","SUDESTE","ESPÍRITO SANTO","232.8682341",10540,4765,4763,2,"2.7"
3200805,"BAIXO GUANDU","SUDESTE","ESPÍRITO SANTO","909.0393354",30674,14061,14049,12,"2.7"
3200904,"BARRA DE SÃO FRANCISCO","SUDESTE","ESPÍRITO SANTO","944.5207855",42498,19818,19802,16,"2.6"
3201001,"BOA ESPERANÇA","SUDESTE","ESPÍRITO SANTO","428.716511",13608,6011,6006,5,"2.7"
3201100,"BOM JESUS DO NORTE","SUDESTE","ESPÍRITO SANTO","89.0840333",10254,4940,4938,2,"2.5"
3201159,"BREJETUBA","SUDESTE","ESPÍRITO SANTO","354.4044571",12985,6029,6024,5,"2.9"
3201209,"CACHOEIRO DE ITAPEMIRIM","SUDESTE","ESPÍRITO SANTO","864.5831017",185786,83793,83764,29,"2.6"
3201308,"CARIACICA","SUDESTE","ESPÍRITO SANTO","279.7180819",353491,152363,152312,51,"2.7"
3201407,"CASTELO","SUDESTE","ESPÍRITO SANTO","663.5148725",36930,17259,17252,7,"2.6"
3201506,"COLATINA","SUDESTE","ESPÍRITO SANTO","1398.2185813",120033,55274,55141,133,"2.6"
3201605,"CONCEIÇÃO DA BARRA","SUDESTE","ESPÍRITO SANTO","1182.5874255",27458,14049,13982,67,"2.8"
3201704,"CONCEIÇÃO DO CASTELO","SUDESTE","ESPÍRITO SANTO","369.7778526",11937,5666,5662,4,"2.7"
3201803,"DIVINO DE SÃO LOURENÇO","SUDESTE","ESPÍRITO SANTO","174.0390172",5083,2577,2576,1,"2.7"
3201902,"DOMINGOS MARTINS","SUDESTE","ESPÍRITO SANTO","1229.2100358",35416,19831,19802,29,"2.7"
3202009,"DORES DO RIO PRETO","SUDESTE","ESPÍRITO SANTO","159.2978645",6596,3261,3250,11,"2.7"
3202108,"ECOPORANGA","SUDESTE","ESPÍRITO SANTO","2285.3691091",21992,11936,11923,13,"2.5"
3202207,"FUNDÃO","SUDESTE","ESPÍRITO SANTO","286.8544444",18014,11274,11253,21,"2.7"
3202256,"GOVERNADOR LINDENBERG","SUDESTE","ESPÍRITO SANTO","360.0159063",11009,4980,4980,0,"2.8"
3202306,"GUAÇUÍ","SUDESTE","ESPÍRITO SANTO","468.1848302",29358,13566,13557,9,"2.7"
3202405,"GUARAPARI","SUDESTE","ESPÍRITO SANTO","589.8253643",124656,85970,85849,121,"2.6"
3202454,"IBATIBA","SUDESTE","ESPÍRITO SANTO","240.277725",25380,11337,11328,9,"2.7"
3202504,"IBIRAÇU","SUDESTE","ESPÍRITO SANTO","201.2479363",11723,5119,5116,3,"2.8"
3202553,"IBITIRAMA","SUDESTE","ESPÍRITO SANTO","330.8744317",9520,4599,4593,6,"2.8"
3202603,"ICONHA","SUDESTE","ESPÍRITO SANTO","203.5276427",12326,5685,5682,3,"2.7"
3202652,"IRUPI","SUDESTE","ESPÍRITO SANTO","184.8073463",13710,6039,6036,3,"2.7"
3202702,"ITAGUAÇU","SUDESTE","ESPÍRITO SANTO","535.020673",13589,6539,6528,11,"2.6"
3202801,"ITAPEMIRIM","SUDESTE","ESPÍRITO SANTO","550.7096598",39832,22122,22100,22,"2.8"
3202900,"ITARANA","SUDESTE","ESPÍRITO SANTO","295.1887955",10597,4603,4600,3,"2.7"
3203007,"IÚNA","SUDESTE","ESPÍRITO SANTO","460.5858667",28590,13105,13082,23,"2.7"
3203056,"JAGUARÉ","SUDESTE","ESPÍRITO SANTO","659.7510865",28931,12199,12186,13,"2.8"
3203106,"JERÔNIMO MONTEIRO","SUDESTE","ESPÍRITO SANTO","177.3420268",11575,5500,5497,3,"2.6"
3203130,"JOÃO NEIVA","SUDESTE","ESPÍRITO SANTO","284.734682",14079,6164,6158,6,"2.7"
3203163,"LARANJA DA TERRA","SUDESTE","ESPÍRITO SANTO","458.3697765",11094,5195,5193,2,"2.6"
3203205,"LINHARES","SUDESTE","ESPÍRITO SANTO","3496.2633782",166786,74739,74572,167,"2.8"
3203304,"MANTENÓPOLIS","SUDESTE","ESPÍRITO SANTO","321.4176231",12770,6733,6725,8,"2.5"
3203320,"MARATAÍZES","SUDESTE","ESPÍRITO SANTO","130.2677851",41929,25300,25279,21,"2.8"
3203346,"MARECHAL FLORIANO","SUDESTE","ESPÍRITO SANTO","285.4949324",17641,9112,9099,13,"2.7"
3203353,"MARILÂNDIA","SUDESTE","ESPÍRITO SANTO","327.6423156",12387,5768,5764,4,"2.6"
3203403,"MIMOSO DO SUL","SUDESTE","ESPÍRITO SANTO","869.4390555",24475,11966,11944,22,"2.6"
3203502,"MONTANHA","SUDESTE","ESPÍRITO SANTO","1099.0597311",18900,8457,8447,10,"2.7"
3203601,"MUCURICI","SUDESTE","ESPÍRITO SANTO","540.5293144",5466,2885,2883,2,"2.6"
3203700,"MUNIZ FREIRE","SUDESTE","ESPÍRITO SANTO","678.8037294",18153,9253,9249,4,"2.7"
3203809,"MUQUI","SUDESTE","ESPÍRITO SANTO","327.2677651",13745,6221,6218,3,"2.7"
3203908,"NOVA VENÉCIA","SUDESTE","ESPÍRITO SANTO","1439.5705025",49065,22704,22683,21,"2.6"
3204005,"PANCAS","SUDESTE","ESPÍRITO SANTO","837.8424795",18893,9030,9019,11,"2.6"
3204054,"PEDRO CANÁRIO","SUDESTE","ESPÍRITO SANTO","433.4528611",21522,9376,9354,22,"2.8"
3204104,"PINHEIROS","SUDESTE","ESPÍRITO SANTO","973.1358465",23915,10379,10367,12,"2.8"
3204203,"PIÚMA","SUDESTE","ESPÍRITO SANTO","74.045803",22300,16542,16498,44,"2.6"
3204252,"PONTO BELO","SUDESTE","ESPÍRITO SANTO","360.1097714",6497,3107,3103,4,"2.6"
3204302,"PRESIDENTE KENNEDY","SUDESTE","ESPÍRITO SANTO","594.8971437",13696,6908,6890,18,"2.7"
3204351,"RIO BANANAL","SUDESTE","ESPÍRITO SANTO","641.9288056",19274,8909,8868,41,"2.8"
3204401,"RIO NOVO DO SUL","SUDESTE","ESPÍRITO SANTO","204.4639253",11069,4938,4934,4,"2.7"
3204500,"SANTA LEOPOLDINA","SUDESTE","ESPÍRITO SANTO","718.3254417",13106,7548,7540,8,"2.6"
3204559,"SANTA MARIA DE JETIBÁ","SUDESTE","ESPÍRITO SANTO","735.1981186",41636,17603,17601,2,"2.8"
3204609,"SANTA TERESA","SUDESTE","ESPÍRITO SANTO","683.0316777",22808,11844,11786,58,"2.6"
3204658,"SÃO DOMINGOS DO NORTE","SUDESTE","ESPÍRITO SANTO","298.5801539",8589,3876,3867,9,"2.7"
3204708,"SÃO GABRIEL DA PALHA","SUDESTE","ESPÍRITO SANTO","434.887118",32252,14822,14792,30,"2.6"
3204807,"SÃO JOSÉ DO CALÇADO","SUDESTE","ESPÍRITO SANTO","273.4892616",10878,5743,5737,6,"2.5"
3204906,"SÃO MATEUS","SUDESTE","ESPÍRITO SANTO","2346.0485374",123752,62132,61973,159,"2.7"
3204955,"SÃO ROQUE DO CANAÃ","SUDESTE","ESPÍRITO SANTO","341.9441366",10886,4986,4984,2,"2.7"
3205002,"SERRA","SUDESTE","ESPÍRITO SANTO","547.6312386",520653,224439,224205,234,"2.7"
3205010,"SOORETAMA","SUDESTE","ESPÍRITO SANTO","587.0362062",26502,11027,10998,29,"2.9"
3205036,"VARGEM ALTA","SUDESTE","ESPÍRITO SANTO","417.7604617",19563,9294,9286,8,"2.7"
3205069,"VENDA NOVA DO IMIGRANTE","SUDESTE","ESPÍRITO SANTO","185.9088445",23831,10255,10244,11,"2.7"
3205101,"VIANA","SUDESTE","ESPÍRITO SANTO","312.2785906",73423,30162,30148,14,"2.8"
3205150,"VILA PAVÃO","SUDESTE","ESPÍRITO SANTO","433.257469",8911,4223,4219,4,"2.7"
3205176,"VILA VALÉRIO","SUDESTE","ESPÍRITO SANTO","470.3429412",13728,6340,6299,41,"2.8"
3205200,"VILA VELHA","SUDESTE","ESPÍRITO SANTO","210.2254291",467722,211518,211421,97,"2.6"
3205309,"VITÓRIA","SUDESTE","ESPÍRITO SANTO","97.1231104",322869,148278,148168,110,"2.5"
3300100,"ANGRA DOS REIS","SUDESTE","RIO DE JANEIRO","813.4196083",167434,93974,93756,218,"2.7"
3300159,"APERIBÉ","SUDESTE","RIO DE JANEIRO","94.541902",11034,5358,5355,3,"2.5"
3300209,"ARARUAMA","SUDESTE","RIO DE JANEIRO","638.2763144",129671,83333,83264,69,"2.7"
3300225,"AREAL","SUDESTE","RIO DE JANEIRO","110.7238146",11828,5818,5815,3,"2.8"
3300233,"ARMAÇÃO DOS BÚZIOS","SUDESTE","RIO DE JANEIRO","70.977365",40006,27542,27186,356,"2.7"
3300258,"ARRAIAL DO CABO","SUDESTE","RIO DE JANEIRO","152.1055128",30986,26990,26944,46,"2.7"
3300308,"BARRA DO PIRAÍ","SUDESTE","RIO DE JANEIRO","584.6095205",92883,42958,42932,26,"2.7"
3300407,"BARRA MANSA","SUDESTE","RIO DE JANEIRO","547.1333658",169894,75342,75312,30,"2.7"
3300456,"BELFORD ROXO","SUDESTE","RIO DE JANEIRO","78.9854279",483087,199691,199664,27,"2.7"
3300506,"BOM JARDIM","SUDESTE","RIO DE JANEIRO","382.4301993",28102,14136,14127,9,"2.6"
3300605,"BOM JESUS DO ITABAPOANA","SUDESTE","RIO DE JANEIRO","596.6594153",35173,17069,17055,14,"2.6"
3300704,"CABO FRIO","SUDESTE","RIO DE JANEIRO","413.4486733",222161,155521,155312,209,"2.7"
3300803,"CACHOEIRAS DE MACACU","SUDESTE","RIO DE JANEIRO","954.7488285",56943,30660,30632,28,"2.6"
3300902,"CAMBUCI","SUDESTE","RIO DE JANEIRO","558.2811758",14616,7673,7668,5,"2.5"
3300936,"CARAPEBUS","SUDESTE","RIO DE JANEIRO","304.8847215",13847,7002,6996,6,"2.7"
3300951,"COMENDADOR LEVY GASPARIAN","SUDESTE","RIO DE JANEIRO","108.639375",8741,3788,3783,5,"2.9"
3301009,"CAMPOS DOS GOYTACAZES","SUDESTE","RIO DE JANEIRO","4032.4868898",483540,234068,233940,128,"2.7"
3301108,"CANTAGALO","SUDESTE","RIO DE JANEIRO","747.2103666",19390,9433,9428,5,"2.7"
3301157,"CARDOSO MOREIRA","SUDESTE","RIO DE JANEIRO","522.5961958",12958,6440,6438,2,"2.6"
3301207,"CARMO","SUDESTE","RIO DE JANEIRO","305.7493438",17198,8059,8019,40,"2.6"
3301306,"CASIMIRO DE ABREU","SUDESTE","RIO DE JANEIRO","462.9178984",46110,24715,24695,20,"2.7"
3301405,"CONCEIÇÃO DE MACABU","SUDESTE","RIO DE JANEIRO","338.2596669",21104,10566,10557,9,"2.7"
3301504,"CORDEIRO","SUDESTE","RIO DE JANEIRO","113.0483026",20783,9635,9628,7,"2.6"
3301603,"DUAS BARRAS","SUDESTE","RIO DE JANEIRO","379.6189735",10980,5502,5495,7,"2.6"
3301702,"DUQUE DE CAXIAS","SUDESTE","RIO DE JANEIRO","467.3191952",808161,355031,354954,77,"2.7"
3301801,"ENGENHEIRO PAULO DE FRONTIN","SUDESTE","RIO DE JANEIRO","139.3807103",12242,6593,6570,23,"2.5"
3301850,"GUAPIMIRIM","SUDESTE","RIO DE JANEIRO","358.4428617",51696,25681,25658,23,"2.8"
3301876,"IGUABA GRANDE","SUDESTE","RIO DE JANEIRO","50.976802",27920,21396,21394,2,"2.7"
3301900,"ITABORAÍ","SUDESTE","RIO DE JANEIRO","429.9605879",224267,111118,111045,73,"2.6"
3302007,"ITAGUAÍ","SUDESTE","RIO DE JANEIRO","282.6065042",116841,57725,57650,75,"2.8"
3302056,"ITALVA","SUDESTE","RIO DE JANEIRO","291.1929455",14073,6691,6683,8,"2.5"
3302106,"ITAOCARA","SUDESTE","RIO DE JANEIRO","433.1816541",22919,11961,11948,13,"2.5"
3302205,"ITAPERUNA","SUDESTE","RIO DE JANEIRO","1106.6940693",101041,49275,49233,42,"2.6"
3302254,"ITATIAIA","SUDESTE","RIO DE JANEIRO","241.03468",30908,15352,15203,149,"2.7"
3302270,"JAPERI","SUDESTE","RIO DE JANEIRO","81.69736",96289,39032,39017,15,"2.8"
3302304,"LAJE DO MURIAÉ","SUDESTE","RIO DE JANEIRO","253.5301203",7336,3794,3794,0,"2.7"
3302403,"MACAÉ","SUDESTE","RIO DE JANEIRO","1216.9886973",246391,123713,123519,194,"2.7"
3302452,"MACUCO","SUDESTE","RIO DE JANEIRO","78.3635294",5415,2223,2221,2,"2.8"
3302502,"MAGÉ","SUDESTE","RIO DE JANEIRO","390.7754386",228127,110188,110149,39,"2.7"
3302601,"MANGARATIBA","SUDESTE","RIO DE JANEIRO","367.606445",41220,43765,43717,48,"2.6"
3302700,"MARICÁ","SUDESTE","RIO DE JANEIRO","361.5720954",197277,106494,106439,55,"2.7"
3302809,"MENDES","SUDESTE","RIO DE JANEIRO","95.3238686",17502,8956,8947,9,"2.5"
3302858,"MESQUITA","SUDESTE","RIO DE JANEIRO","41.1685932",167127,66725,66704,21,"2.7"
3302908,"MIGUEL PEREIRA","SUDESTE","RIO DE JANEIRO","287.9330822",26582,14438,14417,21,"2.6"
3303005,"MIRACEMA","SUDESTE","RIO DE JANEIRO","303.2697394",26881,11720,11707,13,"2.8"
3303104,"NATIVIDADE","SUDESTE","RIO DE JANEIRO","387.0732379",15074,7513,7508,5,"2.6"
3303203,"NILÓPOLIS","SUDESTE","RIO DE JANEIRO","19.3933098",146774,59830,59818,12,"2.6"
3303302,"NITERÓI","SUDESTE","RIO DE JANEIRO","133.7571544",481749,230789,230635,154,"2.5"
3303401,"NOVA FRIBURGO","SUDESTE","RIO DE JANEIRO","935.4288315",189939,97199,97094,105,"2.5"
3303500,"NOVA IGUAÇU","SUDESTE","RIO DE JANEIRO","520.5806683",785867,352117,352044,73,"2.7"
3303609,"PARACAMBI","SUDESTE","RIO DE JANEIRO","190.9488894",41375,19373,19349,24,"2.6"
3303708,"PARAÍBA DO SUL","SUDESTE","RIO DE JANEIRO","571.1173549",42063,19119,19104,15,"2.8"
3303807,"PARATY","SUDESTE","RIO DE JANEIRO","924.2955297",45243,25998,25710,288,"2.8"
3303856,"PATY DO ALFERES","SUDESTE","RIO DE JANEIRO","314.3412346",29619,14303,14285,18,"2.7"
3303906,"PETRÓPOLIS","SUDESTE","RIO DE JANEIRO","791.1443797",278881,138596,138490,106,"2.6"
3303955,"PINHEIRAL","SUDESTE","RIO DE JANEIRO","82.2537153",24298,10853,10847,6,"2.8"
3304003,"PIRAÍ","SUDESTE","RIO DE JANEIRO","490.2552664",27474,13143,13110,33,"2.7"
3304102,"PORCIÚNCULA","SUDESTE","RIO DE JANEIRO","291.8474049",17288,8183,8178,5,"2.7"
3304110,"PORTO REAL","SUDESTE","RIO DE JANEIRO","50.8921138",20373,8723,8719,4,"2.8"
3304128,"QUATIS","SUDESTE","RIO DE JANEIRO","284.8263245",13682,6300,6295,5,"2.7"
3304144,"QUEIMADOS","SUDESTE","RIO DE JANEIRO","75.9267792",140523,61446,61410,36,"2.7"
3304151,"QUISSAMÃ","SUDESTE","RIO DE JANEIRO","719.6429455",22393,11104,11090,14,"2.8"
3304201,"RESENDE","SUDESTE","RIO DE JANEIRO","1099.3356125",129612,59324,59267,57,"2.7"
3304300,"RIO BONITO","SUDESTE","RIO DE JANEIRO","459.4580231",56276,25870,25854,16,"2.7"
3304409,"RIO CLARO","SUDESTE","RIO DE JANEIRO","846.7966966",17401,9146,9131,15,"2.7"
3304508,"RIO DAS FLORES","SUDESTE","RIO DE JANEIRO","478.7831456",8954,3978,3974,4,"2.9"
3304524,"RIO DAS OSTRAS","SUDESTE","RIO DE JANEIRO","228.0440257",156491,88037,87963,74,"2.6"
3304557,"RIO DE JANEIRO","SUDESTE","RIO DE JANEIRO","1200.3295092",6211223,2920214,2918657,1557,"2.5"
3304607,"SANTA MARIA MADALENA","SUDESTE","RIO DE JANEIRO","810.9627314",10232,5510,5500,10,"2.6"
3304706,"SANTO ANTÔNIO DE PÁDUA","SUDESTE","RIO DE JANEIRO","603.6332376",41325,20120,20106,14,"2.6"
3304755,"SÃO FRANCISCO DE ITABAPOANA","SUDESTE","RIO DE JANEIRO","1118.0374355",45059,36190,36156,34,"2.6"
3304805,"SÃO FIDÉLIS","SUDESTE","RIO DE JANEIRO","1034.8329647",38961,19372,19362,10,"2.6"
3304904,"SÃO GONÇALO","SUDESTE","RIO DE JANEIRO","248.1595622",896744,413779,413695,84,"2.5"
3305000,"SÃO JOÃO DA BARRA","SUDESTE","RIO DE JANEIRO","452.3964283",36573,31873,31787,86,"2.5"
3305109,"SÃO JOÃO DE MERITI","SUDESTE","RIO DE JANEIRO","35.2155592",440962,177079,177054,25,"2.6"
3305133,"SÃO JOSÉ DE UBÁ","SUDESTE","RIO DE JANEIRO","249.6883244",7070,3440,3439,1,"2.6"
3305158,"SÃO JOSÉ DO VALE DO RIO PRETO","SUDESTE","RIO DE JANEIRO","220.1776897",22080,10116,10111,5,"2.7"
3305208,"SÃO PEDRO DA ALDEIA","SUDESTE","RIO DE JANEIRO","332.4876369",104029,58519,58474,45,"2.7"
3305307,"SÃO SEBASTIÃO DO ALTO","SUDESTE","RIO DE JANEIRO","397.2137841",7750,3923,3920,3,"2.6"
3305406,"SAPUCAIA","SUDESTE","RIO DE JANEIRO","540.672946",17729,9097,9094,3,"2.6"
3305505,"SAQUAREMA","SUDESTE","RIO DE JANEIRO","352.1295445",89559,63705,63565,140,"2.6"
3305554,"SEROPÉDICA","SUDESTE","RIO DE JANEIRO","265.1890334",80596,39947,39857,90,"2.7"
3305604,"SILVA JARDIM","SUDESTE","RIO DE JANEIRO","937.7552881",21352,12176,12150,26,"2.7"
3305703,"SUMIDOURO","SUDESTE","RIO DE JANEIRO","413.4069687",15206,7209,7205,4,"2.6"
3305752,"TANGUÁ","SUDESTE","RIO DE JANEIRO","143.0069522",31086,14449,14432,17,"2.7"
3305802,"TERESÓPOLIS","SUDESTE","RIO DE JANEIRO","773.3381456",165123,88293,88209,84,"2.6"
3305901,"TRAJANO DE MORAES","SUDESTE","RIO DE JANEIRO","591.1513976",10302,5775,5761,14,"2.6"
3306008,"TRÊS RIOS","SUDESTE","RIO DE JANEIRO","322.8430528",78346,34575,34551,24,"2.8"
3306107,"VALENÇA","SUDESTE","RIO DE JANEIRO","1300.7666697",68088,34123,34050,73,"2.6"
3306156,"VARRE-SAI","SUDESTE","RIO DE JANEIRO","201.9377927",10207,4512,4509,3,"2.8"
3306206,"VASSOURAS","SUDESTE","RIO DE JANEIRO","536.073078",33976,17727,17705,22,"2.6"
3306305,"VOLTA REDONDA","SUDESTE","RIO DE JANEIRO","182.1047612",261563,115652,115585,67,"2.7"
3500105,"ADAMANTINA","SUDESTE","SÃO PAULO","411.9865494",34687,15966,15945,21,"2.5"
3500204,"ADOLFO","SUDESTE","SÃO PAULO","211.0551815",4351,2469,2468,1,"2.6"
3500303,"AGUAÍ","SUDESTE","SÃO PAULO","474.5535511",32072,13586,13579,7,"2.8"
3500402,"ÁGUAS DA PRATA","SUDESTE","SÃO PAULO","142.6728901",7369,3913,3908,5,"2.6"
3500501,"ÁGUAS DE LINDÓIA","SUDESTE","SÃO PAULO","60.1257628",17930,9984,9928,56,"2.6"
3500550,"ÁGUAS DE SANTA BÁRBARA","SUDESTE","SÃO PAULO","404.4627892",7177,4281,4263,18,"2.6"
3500600,"ÁGUAS DE SÃO PEDRO","SUDESTE","SÃO PAULO","3.6121622",2780,1995,1972,23,"2.4"
3500709,"AGUDOS","SUDESTE","SÃO PAULO","966.7079603",37680,15448,15429,19,"2.9"
3500758,"ALAMBARI","SUDESTE","SÃO PAULO","159.6003642",6141,3140,3137,3,"2.9"
3500808,"ALFREDO MARCONDES","SUDESTE","SÃO PAULO","118.9152778",4445,2377,2376,1,"2.6"
3500907,"ALTAIR","SUDESTE","SÃO PAULO","313.0065862",3451,1539,1536,3,"2.7"
3501004,"ALTINÓPOLIS","SUDESTE","SÃO PAULO","928.9563763",16818,7684,7675,9,"2.8"
3501103,"ALTO ALEGRE","SUDESTE","SÃO PAULO","318.5739225",3841,2099,2099,0,"2.5"
3501152,"ALUMÍNIO","SUDESTE","SÃO PAULO","83.6188752",17301,7527,7504,23,"2.9"
3501202,"ÁLVARES FLORENCE","SUDESTE","SÃO PAULO","362.411318",3915,2298,2298,0,"2.5"
3501301,"ÁLVARES MACHADO","SUDESTE","SÃO PAULO","347.6465456",27255,12849,12840,9,"2.8"
3501400,"ÁLVARO DE CARVALHO","SUDESTE","SÃO PAULO","153.6621492",4808,1352,1341,11,"2.7"
3501509,"ALVINLÂNDIA","SUDESTE","SÃO PAULO","84.8790129",2885,1220,1220,0,"2.9"
3501608,"AMERICANA","SUDESTE","SÃO PAULO","133.9122196",237240,104551,104485,66,"2.7"
3501707,"AMÉRICO BRASILIENSE","SUDESTE","SÃO PAULO","122.9576394",33019,12847,12835,12,"2.9"
3501806,"AMÉRICO DE CAMPOS","SUDESTE","SÃO PAULO","252.8756651",5870,2912,2911,1,"2.5"
3501905,"AMPARO","SUDESTE","SÃO PAULO","445.3228765",68008,29292,29229,63,"2.8"
3502002,"ANALÂNDIA","SUDESTE","SÃO PAULO","325.9527937",4589,2523,2516,7,"2.7"
3502101,"ANDRADINA","SUDESTE","SÃO PAULO","964.2261271",59783,25224,25195,29,"2.6"
3502200,"ANGATUBA","SUDESTE","SÃO PAULO","1027.2876771",24022,10965,10956,9,"2.8"
3502309,"ANHEMBI","SUDESTE","SÃO PAULO","736.5572905",5674,3427,3421,6,"2.8"
3502408,"ANHUMAS","SUDESTE","SÃO PAULO","320.840339",4023,1885,1884,1,"2.7"
3502507,"APARECIDA","SUDESTE","SÃO PAULO","120.8899854",32569,13194,13105,89,"2.8"
3502606,"APARECIDA D'OESTE","SUDESTE","SÃO PAULO","179.0036982",4086,2111,2109,2,"2.5"
3502705,"APIAÍ","SUDESTE","SÃO PAULO","974.321954",24585,11099,11088,11,"2.8"
3502754,"ARAÇARIGUAMA","SUDESTE","SÃO PAULO","145.2042244",21522,9603,9563,40,"2.9"
3502804,"ARAÇATUBA","SUDESTE","SÃO PAULO","1167.125598",200124,93668,93605,63,"2.6"
3502903,"ARAÇOIABA DA SERRA","SUDESTE","SÃO PAULO","255.3050137",32443,18474,18460,14,"2.7"
3503000,"ARAMINA","SUDESTE","SÃO PAULO","202.8286893",5420,2478,2475,3,"2.7"
3503109,"ARANDU","SUDESTE","SÃO PAULO","285.9076546",6885,3628,3622,6,"2.9"
3503158,"ARAPEÍ","SUDESTE","SÃO PAULO","156.9028473",2330,1395,1392,3,"2.6"
3503208,"ARARAQUARA","SUDESTE","SÃO PAULO","1003.6254984",242228,113432,113325,107,"2.6"
3503307,"ARARAS","SUDESTE","SÃO PAULO","644.8308737",130866,58931,58853,78,"2.7"
3503356,"ARCO-ÍRIS","SUDESTE","SÃO PAULO","264.9044111",2044,1102,1101,1,"2.8"
3503406,"AREALVA","SUDESTE","SÃO PAULO","506.2262241",8130,5017,5014,3,"2.6"
3503505,"AREIAS","SUDESTE","SÃO PAULO","305.2267245",3577,1775,1766,9,"2.8"
3503604,"AREIÓPOLIS","SUDESTE","SÃO PAULO","85.9066883",10130,3959,3958,1,"3"
3503703,"ARIRANHA","SUDESTE","SÃO PAULO","132.6242157",7602,3435,3433,2,"2.6"
3503802,"ARTUR NOGUEIRA","SUDESTE","SÃO PAULO","178.0262748",51456,21719,21711,8,"2.8"
3503901,"ARUJÁ","SUDESTE","SÃO PAULO","96.1671394",86678,34329,34305,24,"2.9"
3503950,"ASPÁSIA","SUDESTE","SÃO PAULO","69.3734014",1842,877,877,0,"2.7"
3504008,"ASSIS","SUDESTE","SÃO PAULO","460.6087323",101409,44597,44525,72,"2.6"
3504107,"ATIBAIA","SUDESTE","SÃO PAULO","478.5205264",158647,73962,73872,90,"2.8"
3504206,"AURIFLAMA","SUDESTE","SÃO PAULO","434.4980292",13692,6344,6340,4,"2.5"
3504305,"AVAÍ","SUDESTE","SÃO PAULO","540.6885834",4483,2481,2480,1,"2.7"
3504404,"AVANHANDAVA","SUDESTE","SÃO PAULO","338.3700631",11263,4206,4192,14,"2.8"
3504503,"AVARÉ","SUDESTE","SÃO PAULO","1213.0553122",92805,40335,40276,59,"2.7"
3504602,"BADY BASSITT","SUDESTE","SÃO PAULO","110.3716039",27260,12332,12321,11,"2.7"
3504701,"BALBINOS","SUDESTE","SÃO PAULO","91.6345799",3887,697,692,5,"2.5"
3504800,"BÁLSAMO","SUDESTE","SÃO PAULO","149.8809222",9596,4527,4526,1,"2.6"
3504909,"BANANAL","SUDESTE","SÃO PAULO","616.429452",9969,5155,5141,14,"2.7"
3505005,"BARÃO DE ANTONINA","SUDESTE","SÃO PAULO","153.1416182",3531,1947,1941,6,"2.6"
3505104,"BARBOSA","SUDESTE","SÃO PAULO","205.2119407",5640,2879,2878,1,"2.7"
3505203,"BARIRI","SUDESTE","SÃO PAULO","444.4050671",31595,14689,14681,8,"2.7"
3505302,"BARRA BONITA","SUDESTE","SÃO PAULO","150.1206835",34346,14858,14840,18,"2.7"
3505351,"BARRA DO CHAPÉU","SUDESTE","SÃO PAULO","405.6807323",5179,2487,2486,1,"2.8"
3505401,"BARRA DO TURVO","SUDESTE","SÃO PAULO","1007.6844595",6876,3939,3936,3,"2.7"
3505500,"BARRETOS","SUDESTE","SÃO PAULO","1566.1612154",122485,55777,55530,247,"2.6"
3505609,"BARRINHA","SUDESTE","SÃO PAULO","146.0254906",32092,12781,12777,4,"2.9"
3505708,"BARUERI","SUDESTE","SÃO PAULO","65.7007478",316473,124180,124040,140,"2.9"
3505807,"BASTOS","SUDESTE","SÃO PAULO","170.9116036",21503,8817,8812,5,"2.9"
3505906,"BATATAIS","SUDESTE","SÃO PAULO","849.5258653",58402,25135,25114,21,"2.7"
3506003,"BAURU","SUDESTE","SÃO PAULO","667.6836948",379146,171564,171319,245,"2.7"
3506102,"BEBEDOURO","SUDESTE","SÃO PAULO","683.1918008",76373,32710,32675,35,"2.7"
3506201,"BENTO DE ABREU","SUDESTE","SÃO PAULO","301.6870644",2606,1109,1109,0,"2.8"
3506300,"BERNARDINO DE CAMPOS","SUDESTE","SÃO PAULO","244.158118",11607,4678,4674,4,"2.7"
3506359,"BERTIOGA","SUDESTE","SÃO PAULO","491.5457846",64188,61262,61182,80,"2.8"
3506409,"BILAC","SUDESTE","SÃO PAULO","158.0250767",7319,3366,3360,6,"2.6"
3506508,"BIRIGUI","SUDESTE","SÃO PAULO","530.030827",118979,54269,54243,26,"2.6"
3506607,"BIRITIBA MIRIM","SUDESTE","SÃO PAULO","317.4061206",29683,14204,14198,6,"2.8"
3506706,"BOA ESPERANÇA DO SUL","SUDESTE","SÃO PAULO","690.7481378",12978,5539,5534,5,"2.8"
3506805,"BOCAINA","SUDESTE","SÃO PAULO","363.9264623",11259,5080,5074,6,"2.8"
3506904,"BOFETE","SUDESTE","SÃO PAULO","653.5412361",10460,6641,6630,11,"2.7"
3507001,"BOITUVA","SUDESTE","SÃO PAULO","248.9540576",61081,29051,29040,11,"2.8"
3507100,"BOM JESUS DOS PERDÕES","SUDESTE","SÃO PAULO","108.3657312",22006,10320,10313,7,"2.8"
3507159,"BOM SUCESSO DE ITARARÉ","SUDESTE","SÃO PAULO","133.5781357",3555,1493,1490,3,"3"
3507209,"BORÁ","SUDESTE","SÃO PAULO","118.9508617",907,414,413,1,"2.8"
3507308,"BORACÉIA","SUDESTE","SÃO PAULO","122.109677",4715,2027,2027,0,"2.9"
3507407,"BORBOREMA","SUDESTE","SÃO PAULO","552.2563671",14226,7960,7954,6,"2.6"
3507456,"BOREBI","SUDESTE","SÃO PAULO","347.9889004",2713,1248,1248,0,"2.8"
3507506,"BOTUCATU","SUDESTE","SÃO PAULO","1482.6416671",145155,70374,70291,83,"2.7"
3507605,"BRAGANÇA PAULISTA","SUDESTE","SÃO PAULO","512.5836139",176811,76672,76636,36,"2.8"
3507704,"BRAÚNA","SUDESTE","SÃO PAULO","195.1764124",5356,2471,2471,0,"2.7"
3507753,"BREJO ALEGRE","SUDESTE","SÃO PAULO","105.6886454",2565,1327,1327,0,"2.6"
3507803,"BRODOWSKI","SUDESTE","SÃO PAULO","278.458323",25201,10525,10521,4,"2.8"
3507902,"BROTAS","SUDESTE","SÃO PAULO","1101.3732829",23898,11819,11793,26,"2.8"
3508009,"BURI","SUDESTE","SÃO PAULO","1196.4626346",20250,8586,8582,4,"2.9"
3508108,"BURITAMA","SUDESTE","SÃO PAULO","326.9210282",17210,9764,9754,10,"2.6"
3508207,"BURITIZAL","SUDESTE","SÃO PAULO","266.4204103",4356,2042,2040,2,"2.6"
3508306,"CABRÁLIA PAULISTA","SUDESTE","SÃO PAULO","239.9741615",4299,1923,1922,1,"2.7"
3508405,"CABREÚVA","SUDESTE","SÃO PAULO","260.2342735",47011,18788,18772,16,"3"
3508504,"CAÇAPAVA","SUDESTE","SÃO PAULO","368.9903844",96202,40105,40071,34,"2.9"
3508603,"CACHOEIRA PAULISTA","SUDESTE","SÃO PAULO","287.9896839",31564,14684,14653,31,"2.9"
3508702,"CACONDE","SUDESTE","SÃO PAULO","468.2144527",17101,8922,8894,28,"2.7"
3508801,"CAFELÂNDIA","SUDESTE","SÃO PAULO","920.2799988",16654,7809,7801,8,"2.7"
3508900,"CAIABU","SUDESTE","SÃO PAULO","253.3519419",3712,2004,2004,0,"2.5"
3509007,"CAIEIRAS","SUDESTE","SÃO PAULO","97.6420724",95032,36860,36842,18,"2.9"
3509106,"CAIUÁ","SUDESTE","SÃO PAULO","551.1592373",5466,2259,2257,2,"2.5"
3509205,"CAJAMAR","SUDESTE","SÃO PAULO","131.3856178",92689,38908,38884,24,"2.8"
3509254,"CAJATI","SUDESTE","SÃO PAULO","454.4890367",28515,12259,12249,10,"2.9"
3509304,"CAJOBI","SUDESTE","SÃO PAULO","176.9293451",9133,4312,4310,2,"2.6"
3509403,"CAJURU","SUDESTE","SÃO PAULO","660.0878963",23830,11008,10999,9,"2.8"
3509452,"CAMPINA DO MONTE ALEGRE","SUDESTE","SÃO PAULO","184.4788697",5954,3650,3637,13,"2.7"
3509502,"CAMPINAS","SUDESTE","SÃO PAULO","794.5706123",1139047,501951,501383,568,"2.6"
3509601,"CAMPO LIMPO PAULISTA","SUDESTE","SÃO PAULO","79.4028489",77632,31060,31041,19,"2.9"
3509700,"CAMPOS DO JORDÃO","SUDESTE","SÃO PAULO","289.9814523",46974,27197,27001,196,"2.9"
3509809,"CAMPOS NOVOS PAULISTA","SUDESTE","SÃO PAULO","484.1994729",4888,2214,2212,2,"2.7"
3509908,"CANANÉIA","SUDESTE","SÃO PAULO","1237.3541535",12289,7036,6995,41,"2.8"
3509957,"CANAS","SUDESTE","SÃO PAULO","53.2610947",4931,1843,1840,3,"3.1"
3510005,"CÂNDIDO MOTA","SUDESTE","SÃO PAULO","595.810837",29449,13110,13102,8,"2.7"
3510104,"CÂNDIDO RODRIGUES","SUDESTE","SÃO PAULO","70.8918447",2889,1352,1352,0,"2.6"
3510153,"CANITAR","SUDESTE","SÃO PAULO","57.4585675",6283,2440,2440,0,"3"
3510203,"CAPÃO BONITO","SUDESTE","SÃO PAULO","1640.2293095",46337,19480,19463,17,"2.9"
3510302,"CAPELA DO ALTO","SUDESTE","SÃO PAULO","169.8901942",22866,9795,9769,26,"2.9"
3510401,"CAPIVARI","SUDESTE","SÃO PAULO","322.8782526",50068,20421,20404,17,"2.9"
3510500,"CARAGUATATUBA","SUDESTE","SÃO PAULO","484.947281",134873,85408,85271,137,"2.8"
3510609,"CARAPICUÍBA","SUDESTE","SÃO PAULO","34.5457692",386984,150667,150635,32,"2.8"
3510708,"CARDOSO","SUDESTE","SÃO PAULO","639.2482434",11345,6663,6657,6,"2.5"
3510807,"CASA BRANCA","SUDESTE","SÃO PAULO","864.2253615",28083,11921,11867,54,"2.7"
3510906,"CÁSSIA DOS COQUEIROS","SUDESTE","SÃO PAULO","191.6834396",2799,1611,1610,1,"2.6"
3511003,"CASTILHO","SUDESTE","SÃO PAULO","1065.3179228",19977,9814,9810,4,"2.7"
3511102,"CATANDUVA","SUDESTE","SÃO PAULO","290.5957767",115791,52522,52490,32,"2.6"
3511201,"CATIGUÁ","SUDESTE","SÃO PAULO","148.3933066",7003,3075,3073,2,"2.8"
3511300,"CEDRAL","SUDESTE","SÃO PAULO","197.8378072",12618,5626,5621,5,"2.7"
3511409,"CERQUEIRA CÉSAR","SUDESTE","SÃO PAULO","511.6209581",21469,9493,9480,13,"2.7"
3511508,"CERQUILHO","SUDESTE","SÃO PAULO","127.8033175",44695,18329,18313,16,"2.8"
3511607,"CESÁRIO LANGE","SUDESTE","SÃO PAULO","190.391588",19048,8035,8026,9,"2.9"
3511706,"CHARQUEADA","SUDESTE","SÃO PAULO","175.8463831",15535,6830,6825,5,"2.9"
3511904,"CLEMENTINA","SUDESTE","SÃO PAULO","168.5899052",6982,3188,3185,3,"2.7"
3512001,"COLINA","SUDESTE","SÃO PAULO","422.3033929",18486,7547,7538,9,"2.8"
3512100,"COLÔMBIA","SUDESTE","SÃO PAULO","728.6483539",6629,3167,3161,6,"2.8"
3512209,"CONCHAL","SUDESTE","SÃO PAULO","182.792547",28101,11296,11288,8,"3"
3512308,"CONCHAS","SUDESTE","SÃO PAULO","466.1200956",15232,7911,7903,8,"2.7"
3512407,"CORDEIRÓPOLIS","SUDESTE","SÃO PAULO","137.5793108",24514,9894,9889,5,"2.9"
3512506,"COROADOS","SUDESTE","SÃO PAULO","246.8254407",5400,2515,2513,2,"2.7"
3512605,"CORONEL MACEDO","SUDESTE","SÃO PAULO","303.8302628",4280,2169,2168,1,"2.6"
3512704,"CORUMBATAÍ","SUDESTE","SÃO PAULO","278.6217948",4195,2292,2290,2,"2.9"
3512803,"COSMÓPOLIS","SUDESTE","SÃO PAULO","154.6652724",59773,25899,25876,23,"2.8"
3512902,"COSMORAMA","SUDESTE","SÃO PAULO","441.6803382",8719,4267,4266,1,"2.7"
3513009,"COTIA","SUDESTE","SÃO PAULO","323.9938848",274413,119375,119219,156,"2.9"
3513108,"CRAVINHOS","SUDESTE","SÃO PAULO","311.4234132",33281,13019,13010,9,"2.9"
3513207,"CRISTAIS PAULISTA","SUDESTE","SÃO PAULO","385.230202",9272,4665,4662,3,"2.8"
3513306,"CRUZÁLIA","SUDESTE","SÃO PAULO","149.3296621",2108,979,979,0,"2.6"
3513405,"CRUZEIRO","SUDESTE","SÃO PAULO","305.6986851",74961,30750,30732,18,"2.8"
3513504,"CUBATÃO","SUDESTE","SÃO PAULO","142.8793707",112476,46524,46441,83,"2.8"
3513603,"CUNHA","SUDESTE","SÃO PAULO","1407.2500487",22110,13113,13085,28,"2.6"
3513702,"DESCALVADO","SUDESTE","SÃO PAULO","753.7059038",31756,13867,13858,9,"2.8"
3513801,"DIADEMA","SUDESTE","SÃO PAULO","30.7320054",393237,161648,161624,24,"2.7"
3513850,"DIRCE REIS","SUDESTE","SÃO PAULO","88.1332967",1620,879,879,0,"2.5"
3513900,"DIVINOLÂNDIA","SUDESTE","SÃO PAULO","223.7494454",11158,5339,5335,4,"2.6"
3514007,"DOBRADA","SUDESTE","SÃO PAULO","149.7287363",8759,3522,3522,0,"2.8"
3514106,"DOIS CÓRREGOS","SUDESTE","SÃO PAULO","632.9724894",24510,12300,12283,17,"2.7"
3514205,"DOLCINÓPOLIS","SUDESTE","SÃO PAULO","77.9388887",2207,1142,1142,0,"2.5"
3514304,"DOURADO","SUDESTE","SÃO PAULO","205.8744243",8096,4039,4033,6,"2.6"
3514403,"DRACENA","SUDESTE","SÃO PAULO","487.6877529",45474,20547,20518,29,"2.6"
3514502,"DUARTINA","SUDESTE","SÃO PAULO","264.556791",12328,6060,6057,3,"2.6"
3514601,"DUMONT","SUDESTE","SÃO PAULO","111.376466",9471,3809,3806,3,"2.9"
3514700,"ECHAPORÃ","SUDESTE","SÃO PAULO","515.2584241",6205,2883,2883,0,"2.7"
3514809,"ELDORADO","SUDESTE","SÃO PAULO","1654.2562998",13069,6566,6558,8,"2.8"
3514908,"ELIAS FAUSTO","SUDESTE","SÃO PAULO","202.3596069",17699,7471,7468,3,"3"
3514924,"ELISIÁRIO","SUDESTE","SÃO PAULO","93.9795477",3138,1434,1434,0,"2.7"
3514957,"EMBAÚBA","SUDESTE","SÃO PAULO","83.1289209",2323,1144,1144,0,"2.6"
3515004,"EMBU DAS ARTES","SUDESTE","SÃO PAULO","70.3978807",250691,101302,101274,28,"2.8"
3515103,"EMBU-GUAÇU","SUDESTE","SÃO PAULO","155.6411266",66970,29901,29866,35,"2.8"
3515129,"EMILIANÓPOLIS","SUDESTE","SÃO PAULO","225.1673521",3014,1530,1530,0,"2.6"
3515152,"ENGENHEIRO COELHO","SUDESTE","SÃO PAULO","109.9405568",19566,8526,8516,10,"2.8"
3515186,"ESPÍRITO SANTO DO PINHAL","SUDESTE","SÃO PAULO","389.2353797",39816,17042,17027,15,"2.8"
3515194,"ESPÍRITO SANTO DO TURVO","SUDESTE","SÃO PAULO","193.6661164",4157,1853,1805,48,"2.8"
3515202,"ESTRELA D'OESTE","SUDESTE","SÃO PAULO","296.2813566",9417,4016,4009,7,"2.7"
3515301,"ESTRELA DO NORTE","SUDESTE","SÃO PAULO","264.9870306",2703,1258,1257,1,"2.8"
3515350,"EUCLIDES DA CUNHA PAULISTA","SUDESTE","SÃO PAULO","573.8940815",7924,3756,3753,3,"2.6"
3515400,"FARTURA","SUDESTE","SÃO PAULO","429.1705965",16641,7777,7770,7,"2.7"
3515509,"FERNANDÓPOLIS","SUDESTE","SÃO PAULO","549.797201",71186,33231,33204,27,"2.6"
3515608,"FERNANDO PRESTES","SUDESTE","SÃO PAULO","169.990119",5942,2805,2803,2,"2.7"
3515657,"FERNÃO","SUDESTE","SÃO PAULO","100.5044905",1656,852,852,0,"2.7"
3515707,"FERRAZ DE VASCONCELOS","SUDESTE","SÃO PAULO","29.5473099",179198,69683,69663,20,"2.9"
3515806,"FLORA RICA","SUDESTE","SÃO PAULO","224.7114855",1487,833,833,0,"2.4"
3515905,"FLOREAL","SUDESTE","SÃO PAULO","204.2359232",2733,1514,1514,0,"2.4"
3516002,"FLÓRIDA PAULISTA","SUDESTE","SÃO PAULO","524.1376245",12958,4857,4840,17,"2.7"
3516101,"FLORÍNEA","SUDESTE","SÃO PAULO","225.8857611",3851,1624,1622,2,"2.6"
3516200,"FRANCA","SUDESTE","SÃO PAULO","605.6793231",352536,151152,151059,93,"2.7"
3516309,"FRANCISCO MORATO","SUDESTE","SÃO PAULO","49.0010292",165139,63313,63304,9,"2.9"
3516408,"FRANCO DA ROCHA","SUDESTE","SÃO PAULO","132.7748849",144849,56612,56568,44,"2.8"
3516507,"GABRIEL MONTEIRO","SUDESTE","SÃO PAULO","138.6805899",2763,1341,1340,1,"2.6"
3516606,"GÁLIA","SUDESTE","SÃO PAULO","355.913561",6380,3119,3117,2,"2.6"
3516705,"GARÇA","SUDESTE","SÃO PAULO","555.8071549",42110,18107,18084,23,"2.7"
3516804,"GASTÃO VIDIGAL","SUDESTE","SÃO PAULO","180.569154",3252,1726,1722,4,"2.6"
3516853,"GAVIÃO PEIXOTO","SUDESTE","SÃO PAULO","243.7655002",4702,2063,2063,0,"2.9"
3516903,"GENERAL SALGADO","SUDESTE","SÃO PAULO","494.3756944",10312,5027,5020,7,"2.6"
3517000,"GETULINA","SUDESTE","SÃO PAULO","676.754873",10232,4409,4404,5,"2.6"
3517109,"GLICÉRIO","SUDESTE","SÃO PAULO","272.8000253",4138,2782,2781,1,"2.7"
3517208,"GUAIÇARA","SUDESTE","SÃO PAULO","277.1539822",11239,5310,5309,1,"2.8"
3517307,"GUAIMBÊ","SUDESTE","SÃO PAULO","217.8105831",5512,2548,2547,1,"2.7"
3517406,"GUAÍRA","SUDESTE","SÃO PAULO","1258.4653116",39279,16982,16968,14,"2.7"
3517505,"GUAPIAÇU","SUDESTE","SÃO PAULO","325.1264",21711,8871,8867,4,"2.8"
3517604,"GUAPIARA","SUDESTE","SÃO PAULO","408.292486",17071,8298,8297,1,"2.8"
3517703,"GUARÁ","SUDESTE","SÃO PAULO","362.1831614",18606,7891,7885,6,"2.8"
3517802,"GUARAÇAÍ","SUDESTE","SÃO PAULO","569.1972767",7441,3796,3794,2,"2.5"
3517901,"GUARACI","SUDESTE","SÃO PAULO","641.5005975",10350,5625,5620,5,"2.6"
3518008,"GUARANI D'OESTE","SUDESTE","SÃO PAULO","85.7001008",1968,1015,1015,0,"2.4"
3518107,"GUARANTÃ","SUDESTE","SÃO PAULO","461.745731",6427,2970,2967,3,"2.8"
3518206,"GUARARAPES","SUDESTE","SÃO PAULO","955.636817",31043,13820,13806,14,"2.7"
3518305,"GUARAREMA","SUDESTE","SÃO PAULO","270.815698",31236,15282,15272,10,"2.8"
3518404,"GUARATINGUETÁ","SUDESTE","SÃO PAULO","752.6361923",118044,51098,51000,98,"2.8"
3518503,"GUAREÍ","SUDESTE","SÃO PAULO","567.884367",15013,5993,5988,5,"2.7"
3518602,"GUARIBA","SUDESTE","SÃO PAULO","270.2891977",37498,15218,15210,8,"2.8"
3518701,"GUARUJÁ","SUDESTE","SÃO PAULO","144.7943249",287634,160396,160283,113,"2.9"
3518800,"GUARULHOS","SUDESTE","SÃO PAULO","318.6745814",1291771,515164,514984,180,"2.8"
3518859,"GUATAPARÁ","SUDESTE","SÃO PAULO","413.5666136",7320,3372,3369,3,"2.9"
3518909,"GUZOLÂNDIA","SUDESTE","SÃO PAULO","252.477211",4246,2068,2066,2,"2.6"
3519006,"HERCULÂNDIA","SUDESTE","SÃO PAULO","364.2515866",9125,3999,3996,3,"2.8"
3519055,"HOLAMBRA","SUDESTE","SÃO PAULO","65.5769869",15094,5978,5964,14,"2.9"
3519071,"HORTOLÂNDIA","SUDESTE","SÃO PAULO","62.4157003",236641,94245,94185,60,"2.9"
3519105,"IACANGA","SUDESTE","SÃO PAULO","547.3925455",10437,5432,5430,2,"2.6"
3519204,"IACRI","SUDESTE","SÃO PAULO","321.947513",6131,2815,2815,0,"2.7"
3519253,"IARAS","SUDESTE","SÃO PAULO","401.3811054",8010,2240,2222,18,"2.9"
3519303,"IBATÉ","SUDESTE","SÃO PAULO","290.9774904",32178,12675,12660,15,"2.9"
3519402,"IBIRÁ","SUDESTE","SÃO PAULO","271.9120754",11690,5568,5554,14,"2.7"
3519501,"IBIRAREMA","SUDESTE","SÃO PAULO","228.2298429",6385,3051,3048,3,"2.6"
3519600,"IBITINGA","SUDESTE","SÃO PAULO","689.3909828",60033,26695,26683,12,"2.7"
3519709,"IBIÚNA","SUDESTE","SÃO PAULO","1058.0815487",75605,47213,47183,30,"2.9"
3519808,"ICÉM","SUDESTE","SÃO PAULO","362.3552219",7819,3253,3246,7,"2.7"
3519907,"IEPÊ","SUDESTE","SÃO PAULO","594.9743364",7619,3719,3714,5,"2.6"
3520004,"IGARAÇU DO TIETÊ","SUDESTE","SÃO PAULO","97.7471289",23106,9270,9266,4,"2.8"
3520103,"IGARAPAVA","SUDESTE","SÃO PAULO","468.3550203",26212,12017,12010,7,"2.7"
3520202,"IGARATÁ","SUDESTE","SÃO PAULO","292.9526009",10605,6933,6924,9,"2.7"
3520301,"IGUAPE","SUDESTE","SÃO PAULO","1978.7951828",29115,18069,18032,37,"2.7"
3520400,"ILHABELA","SUDESTE","SÃO PAULO","346.3893454",34934,19015,18869,146,"2.7"
3520426,"ILHA COMPRIDA","SUDESTE","SÃO PAULO","196.5672066",13419,16151,15957,194,"2.5"
3520442,"ILHA SOLTEIRA","SUDESTE","SÃO PAULO","652.6413528",25549,12163,12135,28,"2.6"
3520509,"INDAIATUBA","SUDESTE","SÃO PAULO","311.5454107",255748,102177,102095,82,"2.8"
3520608,"INDIANA","SUDESTE","SÃO PAULO","129.3667242",5090,2432,2432,0,"2.7"
3520707,"INDIAPORÃ","SUDESTE","SÃO PAULO","279.6064342",4035,2367,2365,2,"2.4"
3520806,"INÚBIA PAULISTA","SUDESTE","SÃO PAULO","87.1192323",3615,1549,1544,5,"2.7"
3520905,"IPAUSSU","SUDESTE","SÃO PAULO","209.5541727",13712,5889,5884,5,"2.8"
3521002,"IPERÓ","SUDESTE","SÃO PAULO","170.288976",36459,14529,14518,11,"2.9"
3521101,"IPEÚNA","SUDESTE","SÃO PAULO","190.009592",6831,3413,3410,3,"2.9"
3521150,"IPIGUÁ","SUDESTE","SÃO PAULO","136.0278282",6761,3108,3108,0,"2.8"
3521200,"IPORANGA","SUDESTE","SÃO PAULO","1152.0585866",4046,2259,2257,2,"2.8"
3521309,"IPUÃ","SUDESTE","SÃO PAULO","466.4613502",14454,6395,6392,3,"2.7"
3521408,"IRACEMÁPOLIS","SUDESTE","SÃO PAULO","115.1180441",21967,8449,8447,2,"2.9"
3521507,"IRAPUÃ","SUDESTE","SÃO PAULO","257.61151",6867,3145,3144,1,"2.8"
3521606,"IRAPURU","SUDESTE","SÃO PAULO","214.4612711",7085,2956,2950,6,"2.5"
3521705,"ITABERÁ","SUDESTE","SÃO PAULO","1100.2474419",17983,8250,8244,6,"2.8"
3521804,"ITAÍ","SUDESTE","SÃO PAULO","1092.8844263",25180,11737,11725,12,"2.8"
3521903,"ITAJOBI","SUDESTE","SÃO PAULO","502.065828",16989,7431,7426,5,"2.7"
3522000,"ITAJU","SUDESTE","SÃO PAULO","230.3545207",3618,2492,2492,0,"2.8"
3522109,"ITANHAÉM","SUDESTE","SÃO PAULO","601.7114056",112476,93037,92944,93,"2.7"
3522158,"ITAOCA","SUDESTE","SÃO PAULO","183.0145975",3422,1712,1710,2,"2.7"
3522208,"ITAPECERICA DA SERRA","SUDESTE","SÃO PAULO","150.7424393",158522,65136,65078,58,"2.9"
3522307,"ITAPETININGA","SUDESTE","SÃO PAULO","1789.350493",157790,66763,66712,51,"2.8"
3522406,"ITAPEVA","SUDESTE","SÃO PAULO","1826.2579755",89728,38540,38513,27,"2.8"
3522505,"ITAPEVI","SUDESTE","SÃO PAULO","82.6579729",232297,91082,91078,4,"2.8"
3522604,"ITAPIRA","SUDESTE","SÃO PAULO","518.4156989",72022,30942,30914,28,"2.7"
3522653,"ITAPIRAPUÃ PAULISTA","SUDESTE","SÃO PAULO","406.4782826",4306,2029,2027,2,"2.8"
3522703,"ITÁPOLIS","SUDESTE","SÃO PAULO","996.7471223",39493,18405,18389,16,"2.6"
3522802,"ITAPORANGA","SUDESTE","SÃO PAULO","507.9967803",14085,6980,6971,9,"2.7"
3522901,"ITAPUÍ","SUDESTE","SÃO PAULO","140.0229091",13659,5979,5973,6,"2.9"
3523008,"ITAPURA","SUDESTE","SÃO PAULO","301.6530137",3979,2127,2126,1,"2.6"
3523107,"ITAQUAQUECETUBA","SUDESTE","SÃO PAULO","82.6216205",369275,138428,138405,23,"3"
3523206,"ITARARÉ","SUDESTE","SÃO PAULO","1003.860136",44438,19740,19729,11,"2.7"
3523305,"ITARIRI","SUDESTE","SÃO PAULO","273.6666447",15528,8632,8618,14,"2.7"
3523404,"ITATIBA","SUDESTE","SÃO PAULO","322.2693188",121590,51233,51170,63,"2.8"
3523503,"ITATINGA","SUDESTE","SÃO PAULO","979.8174706",19070,7466,7446,20,"3"
3523602,"ITIRAPINA","SUDESTE","SÃO PAULO","564.6026462",16148,7675,7657,18,"2.7"
3523701,"ITIRAPUÃ","SUDESTE","SÃO PAULO","161.1182387",5779,2572,2569,3,"2.9"
3523800,"ITOBI","SUDESTE","SÃO PAULO","138.9859422",8046,3567,3562,5,"2.7"
3523909,"ITU","SUDESTE","SÃO PAULO","640.7191597",168240,73902,73821,81,"2.8"
3524006,"ITUPEVA","SUDESTE","SÃO PAULO","200.8760988",70616,29380,29365,15,"3"
3524105,"ITUVERAVA","SUDESTE","SÃO PAULO","704.659361",37571,16467,16455,12,"2.7"
3524204,"JABORANDI","SUDESTE","SÃO PAULO","273.4379499",6221,2719,2716,3,"2.7"
3524303,"JABOTICABAL","SUDESTE","SÃO PAULO","706.6021971",71821,33350,33323,27,"2.6"
3524402,"JACAREÍ","SUDESTE","SÃO PAULO","464.2722527",240275,100009,99957,52,"2.8"
3524501,"JACI","SUDESTE","SÃO PAULO","145.1328989",7613,3139,3133,6,"2.8"
3524600,"JACUPIRANGA","SUDESTE","SÃO PAULO","704.1360517",16097,8027,8019,8,"2.8"
3524709,"JAGUARIÚNA","SUDESTE","SÃO PAULO","141.390863",59347,23793,23771,22,"2.8"
3524808,"JALES","SUDESTE","SÃO PAULO","368.5740213",48776,22468,22446,22,"2.5"
3524907,"JAMBEIRO","SUDESTE","SÃO PAULO","184.4134599",6397,3383,3378,5,"2.8"
3525003,"JANDIRA","SUDESTE","SÃO PAULO","17.4491108",118045,47344,47342,2,"2.8"
3525102,"JARDINÓPOLIS","SUDESTE","SÃO PAULO","501.8699836",45282,19023,19014,9,"2.9"
3525201,"JARINU","SUDESTE","SÃO PAULO","207.548772",37535,18349,18334,15,"2.9"
3525300,"JAÚ","SUDESTE","SÃO PAULO","687.1026608",133497,58010,57907,103,"2.7"
3525409,"JERIQUARA","SUDESTE","SÃO PAULO","141.9706915",3863,1604,1602,2,"2.9"
3525508,"JOANÓPOLIS","SUDESTE","SÃO PAULO","374.2931914",12815,6509,6499,10,"2.7"
3525607,"JOÃO RAMALHO","SUDESTE","SÃO PAULO","415.452297",4371,1905,1903,2,"2.8"
3525706,"JOSÉ BONIFÁCIO","SUDESTE","SÃO PAULO","860.1996955",36633,16218,16205,13,"2.7"
3525805,"JÚLIO MESQUITA","SUDESTE","SÃO PAULO","128.1830257",4254,1853,1852,1,"2.7"
3525854,"JUMIRIM","SUDESTE","SÃO PAULO","56.6852981",3056,1397,1396,1,"3"
3525904,"JUNDIAÍ","SUDESTE","SÃO PAULO","431.203747",443221,183528,183335,193,"2.7"
3526001,"JUNQUEIRÓPOLIS","SUDESTE","SÃO PAULO","582.5645069",20448,8635,8627,8,"2.7"
3526100,"JUQUIÁ","SUDESTE","SÃO PAULO","812.7990832",17154,9305,9295,10,"2.7"
3526209,"JUQUITIBA","SUDESTE","SÃO PAULO","522.1692836",27404,17123,17108,15,"2.7"
3526308,"LAGOINHA","SUDESTE","SÃO PAULO","255.4721768",5083,3303,3293,10,"2.4"
3526407,"LARANJAL PAULISTA","SUDESTE","SÃO PAULO","384.2736981",26261,12088,12078,10,"2.8"
3526506,"LAVÍNIA","SUDESTE","SÃO PAULO","537.6745927",9689,2375,2351,24,"2.6"
3526605,"LAVRINHAS","SUDESTE","SÃO PAULO","167.0674194",7171,3033,3023,10,"3"
3526704,"LEME","SUDESTE","SÃO PAULO","402.8708595",98161,41410,41390,20,"2.7"
3526803,"LENÇÓIS PAULISTA","SUDESTE","SÃO PAULO","809.541414",66505,27114,27081,33,"2.9"
3526902,"LIMEIRA","SUDESTE","SÃO PAULO","580.7109881",291869,124263,124174,89,"2.8"
3527009,"LINDÓIA","SUDESTE","SÃO PAULO","48.7558781",7014,3718,3705,13,"2.7"
3527108,"LINS","SUDESTE","SÃO PAULO","570.0579944",74779,33359,33309,50,"2.6"
3527207,"LORENA","SUDESTE","SÃO PAULO","414.1597358",84855,35110,35086,24,"2.8"
3527256,"LOURDES","SUDESTE","SÃO PAULO","113.9397423",1950,972,971,1,"2.5"
3527306,"LOUVEIRA","SUDESTE","SÃO PAULO","55.7381232",51847,19245,19230,15,"2.9"
3527405,"LUCÉLIA","SUDESTE","SÃO PAULO","314.8101486",20061,7947,7941,6,"2.6"
3527504,"LUCIANÓPOLIS","SUDESTE","SÃO PAULO","189.535543",2372,1146,1145,1,"2.7"
3527603,"LUÍS ANTÔNIO","SUDESTE","SÃO PAULO","598.256619",12265,5005,5000,5,"2.9"
3527702,"LUIZIÂNIA","SUDESTE","SÃO PAULO","166.5758742",4701,2111,2109,2,"2.7"
3527801,"LUPÉRCIO","SUDESTE","SÃO PAULO","155.1710101",3981,1703,1701,2,"2.7"
3527900,"LUTÉCIA","SUDESTE","SÃO PAULO","475.225975",2661,1302,1302,0,"2.6"
3528007,"MACATUBA","SUDESTE","SÃO PAULO","224.5135775",16829,6655,6647,8,"3"
3528106,"MACAUBAL","SUDESTE","SÃO PAULO","248.0872666",7481,3742,3739,3,"2.5"
3528205,"MACEDÔNIA","SUDESTE","SÃO PAULO","327.5669878",3963,1909,1907,2,"2.6"
3528304,"MAGDA","SUDESTE","SÃO PAULO","312.2819438",3165,1533,1533,0,"2.5"
3528403,"MAIRINQUE","SUDESTE","SÃO PAULO","210.149397",50027,26477,26465,12,"2.9"
3528502,"MAIRIPORÃ","SUDESTE","SÃO PAULO","320.6971487",93853,45401,45364,37,"2.8"
3528601,"MANDURI","SUDESTE","SÃO PAULO","229.0456732",9871,4489,4476,13,"2.7"
3528700,"MARABÁ PAULISTA","SUDESTE","SÃO PAULO","919.5191982",4573,1883,1872,11,"2.5"
3528809,"MARACAÍ","SUDESTE","SÃO PAULO","533.4977041",12673,5823,5819,4,"2.6"
3528858,"MARAPOAMA","SUDESTE","SÃO PAULO","111.2672579",3292,1543,1543,0,"2.7"
3528908,"MARIÁPOLIS","SUDESTE","SÃO PAULO","186.5435104",3513,1781,1780,1,"2.5"
3529005,"MARÍLIA","SUDESTE","SÃO PAULO","1170.5149126",237627,107238,107151,87,"2.7"
3529104,"MARINÓPOLIS","SUDESTE","SÃO PAULO","77.8272675",1860,859,859,0,"2.6"
3529203,"MARTINÓPOLIS","SUDESTE","SÃO PAULO","1253.564363",24881,11277,11261,16,"2.7"
3529302,"MATÃO","SUDESTE","SÃO PAULO","524.8994807",79033,32954,32936,18,"2.7"
3529401,"MAUÁ","SUDESTE","SÃO PAULO","61.9371892",418261,171109,171060,49,"2.7"
3529500,"MENDONÇA","SUDESTE","SÃO PAULO","195.1506832",6159,3598,3598,0,"2.7"
3529609,"MERIDIANO","SUDESTE","SÃO PAULO","228.1985332",4572,2167,2167,0,"2.6"
3529658,"MESÓPOLIS","SUDESTE","SÃO PAULO","148.6362918",1952,944,944,0,"2.6"
3529708,"MIGUELÓPOLIS","SUDESTE","SÃO PAULO","820.8491461",19441,9240,9227,13,"2.7"
3529807,"MINEIROS DO TIETÊ","SUDESTE","SÃO PAULO","213.242467",11230,5698,5695,3,"2.7"
3529906,"MIRACATU","SUDESTE","SÃO PAULO","1001.4841888",18553,10912,10899,13,"2.7"
3530003,"MIRA ESTRELA","SUDESTE","SÃO PAULO","216.8253282",3126,2346,2346,0,"2.5"
3530102,"MIRANDÓPOLIS","SUDESTE","SÃO PAULO","917.6938316",27983,11259,11224,35,"2.6"
3530201,"MIRANTE DO PARANAPANEMA","SUDESTE","SÃO PAULO","1238.9313586",15917,7382,7375,7,"2.6"
3530300,"MIRASSOL","SUDESTE","SÃO PAULO","243.227957",63337,27418,27402,16,"2.7"
3530409,"MIRASSOLÂNDIA","SUDESTE","SÃO PAULO","166.1246661",4669,2202,2201,1,"2.7"
3530508,"MOCOCA","SUDESTE","SÃO PAULO","855.1562835",67681,30269,30247,22,"2.7"
3530607,"MOGI DAS CRUZES","SUDESTE","SÃO PAULO","712.5405561",451505,186123,185993,130,"2.8"
3530706,"MOGI GUAÇU","SUDESTE","SÃO PAULO","812.7533909",153658,64782,64735,47,"2.8"
3530805,"MOGI MIRIM","SUDESTE","SÃO PAULO","497.7076498",92558,40245,40215,30,"2.7"
3530904,"MOMBUCA","SUDESTE","SÃO PAULO","133.69767",3722,1566,1565,1,"3"
3531001,"MONÇÕES","SUDESTE","SÃO PAULO","104.3518185",1937,1081,1081,0,"2.4"
3531100,"MONGAGUÁ","SUDESTE","SÃO PAULO","142.7553723",61951,55788,55694,94,"2.7"
3531209,"MONTE ALEGRE DO SUL","SUDESTE","SÃO PAULO","110.3081748",8627,4805,4638,167,"2.7"
3531308,"MONTE ALTO","SUDESTE","SÃO PAULO","346.949989",47574,21027,21014,13,"2.6"
3531407,"MONTE APRAZÍVEL","SUDESTE","SÃO PAULO","495.5586516",22280,10926,10917,9,"2.6"
3531506,"MONTE AZUL PAULISTA","SUDESTE","SÃO PAULO","263.4625008",18151,8030,8024,6,"2.7"
3531605,"MONTE CASTELO","SUDESTE","SÃO PAULO","233.5474369",4222,2049,2049,0,"2.6"
3531704,"MONTEIRO LOBATO","SUDESTE","SÃO PAULO","332.7420214",4138,2727,2715,12,"2.6"
3531803,"MONTE MOR","SUDESTE","SÃO PAULO","240.566068",64662,27557,27543,14,"2.9"
3531902,"MORRO AGUDO","SUDESTE","SÃO PAULO","1388.1270748",27933,12274,12262,12,"2.8"
3532009,"MORUNGABA","SUDESTE","SÃO PAULO","146.7524562",13720,5595,5587,8,"2.8"
3532058,"MOTUCA","SUDESTE","SÃO PAULO","228.6997109",4034,1706,1706,0,"2.9"
3532108,"MURUTINGA DO SUL","SUDESTE","SÃO PAULO","250.8731973",3737,1900,1898,2,"2.5"
3532157,"NANTES","SUDESTE","SÃO PAULO","286.6471022",2660,1375,1375,0,"2.6"
3532207,"NARANDIBA","SUDESTE","SÃO PAULO","357.3254533",5713,2569,2565,4,"2.8"
3532306,"NATIVIDADE DA SERRA","SUDESTE","SÃO PAULO","833.3720033",6999,6154,6148,6,"2.5"
3532405,"NAZARÉ PAULISTA","SUDESTE","SÃO PAULO","326.2542402",18217,11808,11790,18,"2.7"
3532504,"NEVES PAULISTA","SUDESTE","SÃO PAULO","219.0499393",9699,4561,4559,2,"2.6"
3532603,"NHANDEARA","SUDESTE","SÃO PAULO","436.1593607",9852,5209,5204,5,"2.4"
3532702,"NIPOÃ","SUDESTE","SÃO PAULO","137.6093593",4750,2268,2267,1,"2.7"
3532801,"NOVA ALIANÇA","SUDESTE","SÃO PAULO","217.5151593",6693,3231,3231,0,"2.7"
3532827,"NOVA CAMPINA","SUDESTE","SÃO PAULO","385.3754431",8497,3696,3693,3,"2.9"
3532843,"NOVA CANAÃ PAULISTA","SUDESTE","SÃO PAULO","124.4731185",2032,1176,1176,0,"2.5"
3532868,"NOVA CASTILHO","SUDESTE","SÃO PAULO","183.3964243",1062,575,575,0,"2.7"
3532900,"NOVA EUROPA","SUDESTE","SÃO PAULO","160.2502804",9311,3950,3948,2,"2.8"
3533007,"NOVA GRANADA","SUDESTE","SÃO PAULO","531.7963028",19419,8704,8697,7,"2.7"
3533106,"NOVA GUATAPORANGA","SUDESTE","SÃO PAULO","34.1575304",2156,1058,1058,0,"2.5"
3533205,"NOVA INDEPENDÊNCIA","SUDESTE","SÃO PAULO","265.0287215",4609,1817,1812,5,"2.7"
3533254,"NOVAIS","SUDESTE","SÃO PAULO","117.7719372",4412,1929,1929,0,"2.8"
3533304,"NOVA LUZITÂNIA","SUDESTE","SÃO PAULO","73.8157041",2837,1469,1469,0,"2.5"
3533403,"NOVA ODESSA","SUDESTE","SÃO PAULO","73.7875587",62019,26040,26033,7,"2.8"
3533502,"NOVO HORIZONTE","SUDESTE","SÃO PAULO","931.7426678",38324,18980,18971,9,"2.6"
3533601,"NUPORANGA","SUDESTE","SÃO PAULO","348.2648949",7391,3431,3425,6,"2.7"
3533700,"OCAUÇU","SUDESTE","SÃO PAULO","301.0363465",4331,1989,1988,1,"2.7"
3533809,"ÓLEO","SUDESTE","SÃO PAULO","198.9383343",2512,1523,1514,9,"2.6"
3533908,"OLÍMPIA","SUDESTE","SÃO PAULO","802.5548126",55074,27756,27718,38,"2.7"
3534005,"ONDA VERDE","SUDESTE","SÃO PAULO","242.9458842",4771,2090,2087,3,"2.8"
3534104,"ORIENTE","SUDESTE","SÃO PAULO","218.6682324",6085,2573,2572,1,"2.8"
3534203,"ORINDIÚVA","SUDESTE","SÃO PAULO","247.3775781",6024,2623,2616,7,"2.8"
3534302,"ORLÂNDIA","SUDESTE","SÃO PAULO","291.764966",38319,15334,15328,6,"2.8"
3534401,"OSASCO","SUDESTE","SÃO PAULO","64.9540636",728615,289864,289791,73,"2.8"
3534500,"OSCAR BRESSANE","SUDESTE","SÃO PAULO","222.1304763",2470,1238,1237,1,"2.6"
3534609,"OSVALDO CRUZ","SUDESTE","SÃO PAULO","248.0383328",31272,13312,13289,23,"2.6"
3534708,"OURINHOS","SUDESTE","SÃO PAULO","295.8183134",103970,44446,44422,24,"2.7"
3534757,"OUROESTE","SUDESTE","SÃO PAULO","288.6483593",10294,4718,4715,3,"2.5"
3534807,"OURO VERDE","SUDESTE","SÃO PAULO","266.7777496",7779,3637,3635,2,"2.7"
3534906,"PACAEMBU","SUDESTE","SÃO PAULO","339.3748378",14877,4810,4793,17,"2.6"
3535002,"PALESTINA","SUDESTE","SÃO PAULO","697.700539",11476,5650,5646,4,"2.6"
3535101,"PALMARES PAULISTA","SUDESTE","SÃO PAULO","82.1254397",9650,4009,4008,1,"2.8"
3535200,"PALMEIRA D'OESTE","SUDESTE","SÃO PAULO","318.7398203",8903,4578,4574,4,"2.5"
3535309,"PALMITAL","SUDESTE","SÃO PAULO","548.4067752",19594,8773,8771,2,"2.7"
3535408,"PANORAMA","SUDESTE","SÃO PAULO","356.0499888",14964,7637,7620,17,"2.7"
3535507,"PARAGUAÇU PAULISTA","SUDESTE","SÃO PAULO","1001.4920695",41120,17460,17445,15,"2.7"
3535606,"PARAIBUNA","SUDESTE","SÃO PAULO","809.5762733",17667,10132,10111,21,"2.7"
3535705,"PARAÍSO","SUDESTE","SÃO PAULO","155.1855225",6099,2827,2826,1,"2.7"
3535804,"PARANAPANEMA","SUDESTE","SÃO PAULO","1018.7236769",19395,9565,9549,16,"2.8"
3535903,"PARANAPUÃ","SUDESTE","SÃO PAULO","140.3536431",4031,1772,1768,4,"2.6"
3536000,"PARAPUÃ","SUDESTE","SÃO PAULO","366.6636293",10580,5136,5134,2,"2.6"
3536109,"PARDINHO","SUDESTE","SÃO PAULO","209.8937354",7153,4227,4223,4,"2.9"
3536208,"PARIQUERA-AÇU","SUDESTE","SÃO PAULO","359.4138691",19233,8444,8434,10,"2.8"
3536257,"PARISI","SUDESTE","SÃO PAULO","84.7374035",2892,1328,1328,0,"2.6"
3536307,"PATROCÍNIO PAULISTA","SUDESTE","SÃO PAULO","602.8479278",14512,6663,6653,10,"2.9"
3536406,"PAULICÉIA","SUDESTE","SÃO PAULO","374.091136",7955,5313,5297,16,"2.7"
3536505,"PAULÍNIA","SUDESTE","SÃO PAULO","138.7765612",110537,42684,42609,75,"2.9"
3536570,"PAULISTÂNIA","SUDESTE","SÃO PAULO","256.1777682",2090,1022,1021,1,"2.7"
3536604,"PAULO DE FARIA","SUDESTE","SÃO PAULO","737.9863889",7400,3556,3550,6,"2.5"
3536703,"PEDERNEIRAS","SUDESTE","SÃO PAULO","727.482389",44827,18952,18941,11,"2.9"
3536802,"PEDRA BELA","SUDESTE","SÃO PAULO","158.587259",6557,3572,3571,1,"2.7"
3536901,"PEDRANÓPOLIS","SUDESTE","SÃO PAULO","260.1011726",2787,1426,1419,7,"2.6"
3537008,"PEDREGULHO","SUDESTE","SÃO PAULO","712.6039086",15525,7210,7200,10,"2.8"
3537107,"PEDREIRA","SUDESTE","SÃO PAULO","108.8168967",43112,17646,17635,11,"2.7"
3537156,"PEDRINHAS PAULISTA","SUDESTE","SÃO PAULO","152.3086733",2804,1238,1235,3,"2.6"
3537206,"PEDRO DE TOLEDO","SUDESTE","SÃO PAULO","670.4397486",11281,6920,6914,6,"2.8"
3537305,"PENÁPOLIS","SUDESTE","SÃO PAULO","711.3144994",61679,27750,27721,29,"2.6"
3537404,"PEREIRA BARRETO","SUDESTE","SÃO PAULO","974.2470798",24095,11809,11789,20,"2.6"
3537503,"PEREIRAS","SUDESTE","SÃO PAULO","223.1355887",8737,4565,4561,4,"2.8"
3537602,"PERUÍBE","SUDESTE","SÃO PAULO","326.2156582",68352,53120,53051,69,"2.7"
3537701,"PIACATU","SUDESTE","SÃO PAULO","232.4879439",5519,2476,2475,1,"2.6"
3537800,"PIEDADE","SUDESTE","SÃO PAULO","746.8675864",52970,27013,26979,34,"2.8"
3537909,"PILAR DO SUL","SUDESTE","SÃO PAULO","681.2478179",27619,13053,13047,6,"2.9"
3538006,"PINDAMONHANGABA","SUDESTE","SÃO PAULO","731.3545189",165428,68374,68298,76,"2.8"
3538105,"PINDORAMA","SUDESTE","SÃO PAULO","184.8249033",14542,6422,6412,10,"2.7"
3538204,"PINHALZINHO","SUDESTE","SÃO PAULO","154.5293302",15224,9203,9197,6,"2.7"
3538303,"PIQUEROBI","SUDESTE","SÃO PAULO","482.7691824",3264,1771,1771,0,"2.5"
3538501,"PIQUETE","SUDESTE","SÃO PAULO","175.9959928",12490,5775,5763,12,"2.7"
3538600,"PIRACAIA","SUDESTE","SÃO PAULO","385.5681398",26029,13161,13152,9,"2.7"
3538709,"PIRACICABA","SUDESTE","SÃO PAULO","1378.0689358",423323,190944,190765,179,"2.7"
3538808,"PIRAJU","SUDESTE","SÃO PAULO","504.5906019",29436,13424,13402,22,"2.7"
3538907,"PIRAJUÍ","SUDESTE","SÃO PAULO","823.7575575",22431,9385,9370,15,"2.6"
3539004,"PIRANGI","SUDESTE","SÃO PAULO","215.8088495",10885,4942,4938,4,"2.7"
3539103,"PIRAPORA DO BOM JESUS","SUDESTE","SÃO PAULO","108.489038",18370,7618,7613,5,"3"
3539202,"PIRAPOZINHO","SUDESTE","SÃO PAULO","477.6731969",25348,10875,10868,7,"2.7"
3539301,"PIRASSUNUNGA","SUDESTE","SÃO PAULO","727.1177134",73545,35617,35570,47,"2.7"
3539400,"PIRATININGA","SUDESTE","SÃO PAULO","402.4089102",15108,6877,6865,12,"2.9"
3539509,"PITANGUEIRAS","SUDESTE","SÃO PAULO","430.6379118",33674,14114,14108,6,"2.8"
3539608,"PLANALTO","SUDESTE","SÃO PAULO","289.8252429",4389,2084,2078,6,"2.7"
3539707,"PLATINA","SUDESTE","SÃO PAULO","327.4798121",3025,1412,1412,0,"2.7"
3539806,"POÁ","SUDESTE","SÃO PAULO","17.2636588",103765,40112,40075,37,"2.9"
3539905,"POLONI","SUDESTE","SÃO PAULO","135.1194742",5592,2708,2704,4,"2.6"
3540002,"POMPÉIA","SUDESTE","SÃO PAULO","784.6740154",20196,8942,8900,42,"2.8"
3540101,"PONGAÍ","SUDESTE","SÃO PAULO","183.3991825",3395,1764,1763,1,"2.5"
3540200,"PONTAL","SUDESTE","SÃO PAULO","356.3711974",37607,15448,15444,4,"2.8"
3540259,"PONTALINDA","SUDESTE","SÃO PAULO","209.5247201",4127,1839,1839,0,"2.7"
3540309,"PONTES GESTAL","SUDESTE","SÃO PAULO","217.5054182",2387,1246,1245,1,"2.5"
3540408,"POPULINA","SUDESTE","SÃO PAULO","315.9378247",4127,2122,2120,2,"2.5"
3540507,"PORANGABA","SUDESTE","SÃO PAULO","265.6892541",10451,6931,6923,8,"2.7"
3540606,"PORTO FELIZ","SUDESTE","SÃO PAULO","556.7064063",56497,23720,23700,20,"3"
3540705,"PORTO FERREIRA","SUDESTE","SÃO PAULO","244.9062224",52649,22195,22187,8,"2.8"
3540754,"POTIM","SUDESTE","SÃO PAULO","44.6434863",20392,6465,6454,11,"3.1"
3540804,"POTIRENDABA","SUDESTE","SÃO PAULO","342.4922809",18496,7930,7925,5,"2.7"
3540853,"PRACINHA","SUDESTE","SÃO PAULO","63.0535609",2578,697,692,5,"2.6"
3540903,"PRADÓPOLIS","SUDESTE","SÃO PAULO","167.3781998",17078,6802,6801,1,"2.9"
3541000,"PRAIA GRANDE","SUDESTE","SÃO PAULO","149.6516881",349935,257388,257261,127,"2.7"
3541059,"PRATÂNIA","SUDESTE","SÃO PAULO","175.1002136",5126,2274,2270,4,"2.9"
3541109,"PRESIDENTE ALVES","SUDESTE","SÃO PAULO","286.6422398",3804,1972,1970,2,"2.6"
3541208,"PRESIDENTE BERNARDES","SUDESTE","SÃO PAULO","749.2332217",14490,6490,6479,11,"2.6"
3541307,"PRESIDENTE EPITÁCIO","SUDESTE","SÃO PAULO","1260.2806934",39505,19266,19228,38,"2.6"
3541406,"PRESIDENTE PRUDENTE","SUDESTE","SÃO PAULO","560.6370027",225668,104515,104428,87,"2.6"
3541505,"PRESIDENTE VENCESLAU","SUDESTE","SÃO PAULO","755.202858",35201,15934,15923,11,"2.5"
3541604,"PROMISSÃO","SUDESTE","SÃO PAULO","779.2004159",35131,15316,15307,9,"2.7"
3541653,"QUADRA","SUDESTE","SÃO PAULO","205.6716241",3405,2259,2256,3,"2.8"
3541703,"QUATÁ","SUDESTE","SÃO PAULO","651.3408865",13163,5680,5675,5,"2.7"
3541802,"QUEIROZ","SUDESTE","SÃO PAULO","234.9141578",3265,1513,1512,1,"2.7"
3541901,"QUELUZ","SUDESTE","SÃO PAULO","249.3989972",9159,3868,3856,12,"2.8"
3542008,"QUINTANA","SUDESTE","SÃO PAULO","318.9370857",7038,2889,2887,2,"2.8"
3542107,"RAFARD","SUDESTE","SÃO PAULO","121.6453465",8965,3543,3539,4,"2.9"
3542206,"RANCHARIA","SUDESTE","SÃO PAULO","1587.4977015",28588,13447,13436,11,"2.7"
3542305,"REDENÇÃO DA SERRA","SUDESTE","SÃO PAULO","309.4410767",4494,3579,3573,6,"2.7"
3542404,"REGENTE FEIJÓ","SUDESTE","SÃO PAULO","263.2797934",20145,8859,8852,7,"2.7"
3542503,"REGINÓPOLIS","SUDESTE","SÃO PAULO","410.4061981",7662,2847,2842,5,"2.6"
3542602,"REGISTRO","SUDESTE","SÃO PAULO","722.2014685",59947,25748,25712,36,"2.8"
3542701,"RESTINGA","SUDESTE","SÃO PAULO","245.7459807",6404,2731,2730,1,"2.9"
3542800,"RIBEIRA","SUDESTE","SÃO PAULO","335.7585155",3132,1733,1732,1,"2.7"
3542909,"RIBEIRÃO BONITO","SUDESTE","SÃO PAULO","471.5530706",10989,5166,5164,2,"2.7"
3543006,"RIBEIRÃO BRANCO","SUDESTE","SÃO PAULO","697.4997777",18627,8599,8595,4,"2.8"
3543105,"RIBEIRÃO CORRENTE","SUDESTE","SÃO PAULO","148.3317779",4608,1954,1954,0,"2.9"
3543204,"RIBEIRÃO DO SUL","SUDESTE","SÃO PAULO","203.2083629",4677,2148,2147,1,"2.7"
3543238,"RIBEIRÃO DOS ÍNDIOS","SUDESTE","SÃO PAULO","196.446161",2025,1028,1028,0,"2.5"
3543253,"RIBEIRÃO GRANDE","SUDESTE","SÃO PAULO","333.3634005",7450,3617,3617,0,"2.8"
3543303,"RIBEIRÃO PIRES","SUDESTE","SÃO PAULO","98.9718431",115559,44662,44632,30,"2.8"
3543402,"RIBEIRÃO PRETO","SUDESTE","SÃO PAULO","650.915604",698642,321949,321604,345,"2.6"
3543501,"RIVERSUL","SUDESTE","SÃO PAULO","385.877988",5599,2898,2897,1,"2.6"
3543600,"RIFAINA","SUDESTE","SÃO PAULO","162.5084274",4049,2811,2780,31,"2.8"
3543709,"RINCÃO","SUDESTE","SÃO PAULO","316.6388147",9098,4736,4735,1,"2.7"
3543808,"RINÓPOLIS","SUDESTE","SÃO PAULO","358.4806352",9259,4312,4308,4,"2.6"
3543907,"RIO CLARO","SUDESTE","SÃO PAULO","498.422385",201418,87946,87878,68,"2.7"
3544004,"RIO DAS PEDRAS","SUDESTE","SÃO PAULO","226.6568139",31328,13137,13122,15,"2.9"
3544103,"RIO GRANDE DA SERRA","SUDESTE","SÃO PAULO","36.3407906",44170,17944,17928,16,"2.8"
3544202,"RIOLÂNDIA","SUDESTE","SÃO PAULO","631.896807",10309,3749,3741,8,"2.6"
3544251,"ROSANA","SUDESTE","SÃO PAULO","744.0105135",17440,9038,9023,15,"2.6"
3544301,"ROSEIRA","SUDESTE","SÃO PAULO","129.8465336",10832,4365,4360,5,"3"
3544400,"RUBIÁCEA","SUDESTE","SÃO PAULO","236.4837545",2700,1267,1267,0,"2.7"
3544509,"RUBINÉIA","SUDESTE","SÃO PAULO","242.8765292",3833,2521,2503,18,"2.5"
3544608,"SABINO","SUDESTE","SÃO PAULO","305.2845388",5112,2966,2964,2,"2.5"
3544707,"SAGRES","SUDESTE","SÃO PAULO","147.9353288",2474,1127,1127,0,"2.7"
3544806,"SALES","SUDESTE","SÃO PAULO","308.5552754",6437,4748,4744,4,"2.6"
3544905,"SALES OLIVEIRA","SUDESTE","SÃO PAULO","305.7760268",11411,4937,4933,4,"2.8"
3545001,"SALESÓPOLIS","SUDESTE","SÃO PAULO","424.9971861",15202,8271,8258,13,"2.8"
3545100,"SALMOURÃO","SUDESTE","SÃO PAULO","172.9339692",4808,2102,2101,1,"2.7"
3545159,"SALTINHO","SUDESTE","SÃO PAULO","99.7380958",8161,3465,3464,1,"2.8"
3545209,"SALTO","SUDESTE","SÃO PAULO","133.0565521",134319,54258,54211,47,"2.9"
3545308,"SALTO DE PIRAPORA","SUDESTE","SÃO PAULO","280.4122923",43748,21659,21642,17,"2.9"
3545407,"SALTO GRANDE","SUDESTE","SÃO PAULO","188.4408505",9050,4381,4376,5,"2.7"
3545506,"SANDOVALINA","SUDESTE","SÃO PAULO","455.8559379",3645,1600,1599,1,"2.8"
3545605,"SANTA ADÉLIA","SUDESTE","SÃO PAULO","330.2689034",14018,6330,6325,5,"2.7"
3545704,"SANTA ALBERTINA","SUDESTE","SÃO PAULO","272.6917259",6393,3330,3324,6,"2.5"
3545803,"SANTA BÁRBARA D'OESTE","SUDESTE","SÃO PAULO","271.0299116",183347,74932,74863,69,"2.8"
3546009,"SANTA BRANCA","SUDESTE","SÃO PAULO","272.2376677",13975,8095,8090,5,"2.7"
3546108,"SANTA CLARA D'OESTE","SUDESTE","SÃO PAULO","183.4582784",2598,1302,1299,3,"2.7"
3546207,"SANTA CRUZ DA CONCEIÇÃO","SUDESTE","SÃO PAULO","150.1300952",4277,2335,2332,3,"2.6"
3546256,"SANTA CRUZ DA ESPERANÇA","SUDESTE","SÃO PAULO","148.0623066",2116,1141,1141,0,"2.8"
3546306,"SANTA CRUZ DAS PALMEIRAS","SUDESTE","SÃO PAULO","295.3373637",28864,12131,12124,7,"2.8"
3546405,"SANTA CRUZ DO RIO PARDO","SUDESTE","SÃO PAULO","1114.7473577",46442,20305,20284,21,"2.8"
3546504,"SANTA ERNESTINA","SUDESTE","SÃO PAULO","134.4212545",6118,2615,2615,0,"2.8"
3546603,"SANTA FÉ DO SUL","SUDESTE","SÃO PAULO","206.5365071",34794,16374,16359,15,"2.6"
3546702,"SANTA GERTRUDES","SUDESTE","SÃO PAULO","98.2910785",23611,9002,8996,6,"2.9"
3546801,"SANTA ISABEL","SUDESTE","SÃO PAULO","363.3318737",53174,26017,25995,22,"2.8"
3546900,"SANTA LÚCIA","SUDESTE","SÃO PAULO","153.8604527",7149,2873,2872,1,"2.9"
3547007,"SANTA MARIA DA SERRA","SUDESTE","SÃO PAULO","252.6207144",5243,2840,2837,3,"2.8"
3547106,"SANTA MERCEDES","SUDESTE","SÃO PAULO","166.7528595",2956,1521,1520,1,"2.6"
3547205,"SANTANA DA PONTE PENSA","SUDESTE","SÃO PAULO","129.8882028",1670,924,924,0,"2.5"
3547304,"SANTANA DE PARNAÍBA","SUDESTE","SÃO PAULO","179.9494428",154105,59167,59161,6,"2.9"
3547403,"SANTA RITA D'OESTE","SUDESTE","SÃO PAULO","209.7998756",2733,1368,1368,0,"2.5"
3547502,"SANTA RITA DO PASSA QUATRO","SUDESTE","SÃO PAULO","754.1405418",24833,12604,12557,47,"2.6"
3547601,"SANTA ROSA DE VITERBO","SUDESTE","SÃO PAULO","288.5764676",23411,10444,10436,8,"2.7"
3547650,"SANTA SALETE","SUDESTE","SÃO PAULO","79.1924794",1645,842,842,0,"2.5"
3547700,"SANTO ANASTÁCIO","SUDESTE","SÃO PAULO","552.875633",17963,8348,8342,6,"2.6"
3547809,"SANTO ANDRÉ","SUDESTE","SÃO PAULO","175.7818753",748919,322856,322621,235,"2.7"
3547908,"SANTO ANTÔNIO DA ALEGRIA","SUDESTE","SÃO PAULO","310.3108316",6775,3557,3554,3,"2.6"
3548005,"SANTO ANTÔNIO DE POSSE","SUDESTE","SÃO PAULO","154.1325527",23244,9517,9515,2,"2.9"
3548054,"SANTO ANTÔNIO DO ARACANGUÁ","SUDESTE","SÃO PAULO","1308.4322222",8379,5532,5527,5,"2.7"
3548104,"SANTO ANTÔNIO DO JARDIM","SUDESTE","SÃO PAULO","109.9559614",6126,2753,2747,6,"2.9"
3548203,"SANTO ANTÔNIO DO PINHAL","SUDESTE","SÃO PAULO","133.0083983",7133,4212,4177,35,"2.7"
3548302,"SANTO EXPEDITO","SUDESTE","SÃO PAULO","94.4653934",3000,1640,1640,0,"2.5"
3548401,"SANTÓPOLIS DO AGUAPEÍ","SUDESTE","SÃO PAULO","128.0261101",3899,1680,1679,1,"2.7"
3548500,"SANTOS","SUDESTE","SÃO PAULO","281.0329823",418608,208688,208507,181,"2.5"
3548609,"SÃO BENTO DO SAPUCAÍ","SUDESTE","SÃO PAULO","252.5794411",11674,6338,6297,41,"2.7"
3548708,"SÃO BERNARDO DO CAMPO","SUDESTE","SÃO PAULO","409.5322513",810729,333296,333176,120,"2.7"
3548807,"SÃO CAETANO DO SUL","SUDESTE","SÃO PAULO","15.3307262",165655,70743,70688,55,"2.7"
3548906,"SÃO CARLOS","SUDESTE","SÃO PAULO","1136.9072671",254857,122473,122374,99,"2.6"
3549003,"SÃO FRANCISCO","SUDESTE","SÃO PAULO","75.5791713",2602,1301,1301,0,"2.5"
3549102,"SÃO JOÃO DA BOA VISTA","SUDESTE","SÃO PAULO","516.398938",92547,41959,41929,30,"2.7"
3549201,"SÃO JOÃO DAS DUAS PONTES","SUDESTE","SÃO PAULO","129.462315",2580,1265,1265,0,"2.6"
3549250,"SÃO JOÃO DE IRACEMA","SUDESTE","SÃO PAULO","178.3964796",1846,869,869,0,"2.7"
3549300,"SÃO JOÃO DO PAU D'ALHO","SUDESTE","SÃO PAULO","117.6645497",2242,1160,1159,1,"2.4"
3549409,"SÃO JOAQUIM DA BARRA","SUDESTE","SÃO PAULO","410.8627632",48558,20014,20003,11,"2.8"
3549508,"SÃO JOSÉ DA BELA VISTA","SUDESTE","SÃO PAULO","276.9518869",7626,3327,3324,3,"2.8"
3549607,"SÃO JOSÉ DO BARREIRO","SUDESTE","SÃO PAULO","570.685256",3853,2207,2192,15,"2.7"
3549706,"SÃO JOSÉ DO RIO PARDO","SUDESTE","SÃO PAULO","419.684433",52205,22712,22688,24,"2.8"
3549805,"SÃO JOSÉ DO RIO PRETO","SUDESTE","SÃO PAULO","431.9439067",480393,220173,220032,141,"2.6"
3549904,"SÃO JOSÉ DOS CAMPOS","SUDESTE","SÃO PAULO","1099.4094101",697054,282214,281931,283,"2.8"
3549953,"SÃO LOURENÇO DA SERRA","SUDESTE","SÃO PAULO","186.4560344",16067,8623,8617,6,"2.7"
3550001,"SÃO LUIZ DO PARAITINGA","SUDESTE","SÃO PAULO","617.3154248",10337,6395,6378,17,"2.5"
3550100,"SÃO MANUEL","SUDESTE","SÃO PAULO","650.7335499",37289,16644,16633,11,"2.8"
3550209,"SÃO MIGUEL ARCANJO","SUDESTE","SÃO PAULO","930.3392261",32039,14207,14189,18,"2.8"
3550308,"SÃO PAULO","SUDESTE","SÃO PAULO","1521.2015865",11451999,4996529,4992162,4367,"2.6"
3550407,"SÃO PEDRO","SUDESTE","SÃO PAULO","611.2778299",38256,19033,19008,25,"2.7"
3550506,"SÃO PEDRO DO TURVO","SUDESTE","SÃO PAULO","731.2213549",7217,3414,3407,7,"2.8"
3550605,"SÃO ROQUE","SUDESTE","SÃO PAULO","306.9084533",79484,37379,37326,53,"2.8"
3550704,"SÃO SEBASTIÃO","SUDESTE","SÃO PAULO","402.3948317",81595,53841,53591,250,"2.8"
3550803,"SÃO SEBASTIÃO DA GRAMA","SUDESTE","SÃO PAULO","252.4096022",10441,5154,5151,3,"2.7"
3550902,"SÃO SIMÃO","SUDESTE","SÃO PAULO","617.2523189",13442,6420,6415,5,"2.7"
3551009,"SÃO VICENTE","SUDESTE","SÃO PAULO","148.1510544",329911,146756,146672,84,"2.7"
3551108,"SARAPUÍ","SUDESTE","SÃO PAULO","352.5923759",10369,5664,5660,4,"2.8"
3551207,"SARUTAIÁ","SUDESTE","SÃO PAULO","141.6076085",3704,1799,1798,1,"2.7"
3551306,"SEBASTIANÓPOLIS DO SUL","SUDESTE","SÃO PAULO","167.8482762",3130,1667,1666,1,"2.5"
3551405,"SERRA AZUL","SUDESTE","SÃO PAULO","283.1435511",12746,4557,4551,6,"2.9"
3551504,"SERRANA","SUDESTE","SÃO PAULO","126.0460313",43909,17106,17094,12,"2.9"
3551603,"SERRA NEGRA","SUDESTE","SÃO PAULO","203.7343472",29894,16536,16507,29,"2.7"
3551702,"SERTÃOZINHO","SUDESTE","SÃO PAULO","403.0886141",126887,53601,53579,22,"2.8"
3551801,"SETE BARRAS","SUDESTE","SÃO PAULO","1062.699411",12730,6418,6407,11,"2.8"
3551900,"SEVERÍNIA","SUDESTE","SÃO PAULO","140.4596411",14576,5844,5835,9,"2.9"
3552007,"SILVEIRAS","SUDESTE","SÃO PAULO","414.7818328",6186,3489,3486,3,"2.8"
3552106,"SOCORRO","SUDESTE","SÃO PAULO","449.0292364",40122,20774,20736,38,"2.6"
3552205,"SOROCABA","SUDESTE","SÃO PAULO","449.8722509",723682,307419,307124,295,"2.8"
3552304,"SUD MENNUCCI","SUDESTE","SÃO PAULO","594.7437281",7355,3467,3445,22,"2.6"
3552403,"SUMARÉ","SUDESTE","SÃO PAULO","153.4652459",279545,112489,112437,52,"2.8"
3552502,"SUZANO","SUDESTE","SÃO PAULO","206.2358135",307429,122708,122640,68,"2.9"
3552551,"SUZANÁPOLIS","SUDESTE","SÃO PAULO","330.5865831",3408,1637,1636,1,"2.7"
3552601,"TABAPUÃ","SUDESTE","SÃO PAULO","345.791731",11323,5536,5532,4,"2.6"
3552700,"TABATINGA","SUDESTE","SÃO PAULO","368.6036403",14769,6766,6763,3,"2.7"
3552809,"TABOÃO DA SERRA","SUDESTE","SÃO PAULO","20.3877753",273542,111510,111492,18,"2.7"
3552908,"TACIBA","SUDESTE","SÃO PAULO","607.2666051",6260,2962,2960,2,"2.7"
3553005,"TAGUAÍ","SUDESTE","SÃO PAULO","145.3317004",12669,4872,4870,2,"2.9"
3553104,"TAIAÇU","SUDESTE","SÃO PAULO","107.0587344",5677,2567,2566,1,"2.7"
3553203,"TAIÚVA","SUDESTE","SÃO PAULO","132.4590141",6548,2632,2631,1,"2.6"
3553302,"TAMBAÚ","SUDESTE","SÃO PAULO","561.7880384",21435,9183,9172,11,"2.8"
3553401,"TANABI","SUDESTE","SÃO PAULO","747.2183287",25265,12243,12232,11,"2.6"
3553500,"TAPIRAÍ","SUDESTE","SÃO PAULO","755.1005252",7996,4266,4255,11,"2.8"
3553609,"TAPIRATIBA","SUDESTE","SÃO PAULO","221.8913637",11816,5255,5246,9,"2.8"
3553658,"TAQUARAL","SUDESTE","SÃO PAULO","53.8920606",2619,1085,1085,0,"2.8"
3553708,"TAQUARITINGA","SUDESTE","SÃO PAULO","594.3347072",52260,23210,23188,22,"2.6"
3553807,"TAQUARITUBA","SUDESTE","SÃO PAULO","448.5149297",24350,9658,9628,30,"2.8"
3553856,"TAQUARIVAÍ","SUDESTE","SÃO PAULO","231.7924289",6876,2957,2953,4,"2.9"
3553906,"TARABAI","SUDESTE","SÃO PAULO","201.3845248",6536,2889,2886,3,"2.8"
3553955,"TARUMÃ","SUDESTE","SÃO PAULO","302.9133104",14882,5960,5956,4,"2.8"
3554003,"TATUÍ","SUDESTE","SÃO PAULO","523.7494183",123942,54084,54054,30,"2.8"
3554102,"TAUBATÉ","SUDESTE","SÃO PAULO","625.0030826",310739,133141,133046,95,"2.7"
3554201,"TEJUPÁ","SUDESTE","SÃO PAULO","296.1893646",4127,2116,2115,1,"2.9"
3554300,"TEODORO SAMPAIO","SUDESTE","SÃO PAULO","1555.8030022",22173,9903,9891,12,"2.7"
3554409,"TERRA ROXA","SUDESTE","SÃO PAULO","221.5405099",7904,3549,3548,1,"2.7"
3554508,"TIETÊ","SUDESTE","SÃO PAULO","404.3957832",37663,16093,16069,24,"2.7"
3554607,"TIMBURI","SUDESTE","SÃO PAULO","196.789857",2464,1497,1496,1,"2.5"
3554656,"TORRE DE PEDRA","SUDESTE","SÃO PAULO","71.3477302",2046,1411,1394,17,"2.5"
3554706,"TORRINHA","SUDESTE","SÃO PAULO","315.2668095",9335,4330,4320,10,"2.7"
3554755,"TRABIJU","SUDESTE","SÃO PAULO","63.4210962",1682,787,786,1,"2.8"
3554805,"TREMEMBÉ","SUDESTE","SÃO PAULO","191.094346",51173,17826,17780,46,"2.9"
3554904,"TRÊS FRONTEIRAS","SUDESTE","SÃO PAULO","151.5937621",6804,3308,3303,5,"2.6"
3554953,"TUIUTI","SUDESTE","SÃO PAULO","126.7306369",6778,3939,3936,3,"2.7"
3555000,"TUPÃ","SUDESTE","SÃO PAULO","627.9863244",63928,28592,28542,50,"2.6"
3555109,"TUPI PAULISTA","SUDESTE","SÃO PAULO","244.7697813",15854,6898,6890,8,"2.5"
3555208,"TURIÚBA","SUDESTE","SÃO PAULO","153.2350148",1818,1230,1230,0,"2.4"
3555307,"TURMALINA","SUDESTE","SÃO PAULO","147.7965877",1669,962,961,1,"2.3"
3555356,"UBARANA","SUDESTE","SÃO PAULO","209.860692",5365,2489,2489,0,"2.8"
3555406,"UBATUBA","SUDESTE","SÃO PAULO","708.1045856",92981,79563,79172,391,"2.7"
3555505,"UBIRAJARA","SUDESTE","SÃO PAULO","282.1794243",5132,2375,2373,2,"2.8"
3555604,"UCHOA","SUDESTE","SÃO PAULO","252.4338666",10394,4702,4700,2,"2.6"
3555703,"UNIÃO PAULISTA","SUDESTE","SÃO PAULO","79.056485",1603,722,722,0,"2.7"
3555802,"URÂNIA","SUDESTE","SÃO PAULO","209.2617276",8833,4171,4168,3,"2.6"
3555901,"URU","SUDESTE","SÃO PAULO","146.9010403",1387,866,865,1,"2.6"
3556008,"URUPÊS","SUDESTE","SÃO PAULO","323.9162764",13744,6339,6336,3,"2.6"
3556107,"VALENTIM GENTIL","SUDESTE","SÃO PAULO","149.741243",14098,6127,6122,5,"2.7"
3556206,"VALINHOS","SUDESTE","SÃO PAULO","148.537786",126373,53724,53686,38,"2.7"
3556305,"VALPARAÍSO","SUDESTE","SÃO PAULO","857.661098",24241,8601,8587,14,"2.7"
3556354,"VARGEM","SUDESTE","SÃO PAULO","142.594573",10512,5244,5243,1,"2.9"
3556404,"VARGEM GRANDE DO SUL","SUDESTE","SÃO PAULO","267.1783008",40133,16991,16965,26,"2.7"
3556453,"VARGEM GRANDE PAULISTA","SUDESTE","SÃO PAULO","42.4893998",50415,21049,21040,9,"2.9"
3556503,"VÁRZEA PAULISTA","SUDESTE","SÃO PAULO","35.1197578",115771,44554,44541,13,"2.9"
3556602,"VERA CRUZ","SUDESTE","SÃO PAULO","247.7164146",10176,4140,4134,6,"2.8"
3556701,"VINHEDO","SUDESTE","SÃO PAULO","80.9495176",76540,31607,31582,25,"2.8"
3556800,"VIRADOURO","SUDESTE","SÃO PAULO","217.726444",17414,7674,7670,4,"2.8"
3556909,"VISTA ALEGRE DO ALTO","SUDESTE","SÃO PAULO","95.4290105",8109,3261,3261,0,"2.8"
3556958,"VITÓRIA BRASIL","SUDESTE","SÃO PAULO","49.8321485",1794,834,834,0,"2.6"
3557006,"VOTORANTIM","SUDESTE","SÃO PAULO","184.1862413",127923,50726,50713,13,"2.9"
3557105,"VOTUPORANGA","SUDESTE","SÃO PAULO","420.7033727",96634,44051,44041,10,"2.6"
3557154,"ZACARIAS","SUDESTE","SÃO PAULO","319.055584",2692,1617,1617,0,"2.5"
3557204,"CHAVANTES","SUDESTE","SÃO PAULO","188.7269833",12211,5199,5194,5,"2.8"
3557303,"ESTIVA GERBI","SUDESTE","SÃO PAULO","74.1436512",11295,4559,4556,3,"2.9"
4100103,"ABATIÁ","SUL","PARANÁ","228.7169745",7241,3372,3370,2,"2.7"
4100202,"ADRIANÓPOLIS","SUL","PARANÁ","1349.3108586",6256,3275,3258,17,"2.7"
4100301,"AGUDOS DO SUL","SUL","PARANÁ","192.2611653",10233,4929,4920,9,"2.8"
4100400,"ALMIRANTE TAMANDARÉ","SUL","PARANÁ","194.2282595",119825,46281,46264,17,"2.9"
4100459,"ALTAMIRA DO PARANÁ","SUL","PARANÁ","386.9451083",3590,1766,1766,0,"2.7"
4100509,"ALTÔNIA","SUL","PARANÁ","661.5600031",18742,8871,8861,10,"2.6"
4100608,"ALTO PARANÁ","SUL","PARANÁ","407.7190505",13909,5928,5923,5,"2.7"
4100707,"ALTO PIQUIRI","SUL","PARANÁ","447.6663202",9727,4370,4364,6,"2.6"
4100806,"ALVORADA DO SUL","SUL","PARANÁ","424.2495465",10326,6581,6577,4,"2.6"
4100905,"AMAPORÃ","SUL","PARANÁ","384.7346418",4762,2146,2145,1,"2.7"
4101002,"AMPÉRE","SUL","PARANÁ","298.3486719",19620,8102,8101,1,"2.7"
4101051,"ANAHY","SUL","PARANÁ","102.8945479",2918,1328,1328,0,"2.6"
4101101,"ANDIRÁ","SUL","PARANÁ","235.9437062",19878,8767,8760,7,"2.6"
4101150,"ÂNGULO","SUL","PARANÁ","106.021035",3235,1487,1487,0,"2.6"
4101200,"ANTONINA","SUL","PARANÁ","891.5820784",18091,9794,9776,18,"2.8"
4101309,"ANTÔNIO OLINTO","SUL","PARANÁ","469.6203833",7018,3837,3835,2,"2.5"
4101408,"APUCARANA","SUL","PARANÁ","556.9900718",130134,56051,56024,27,"2.7"
4101507,"ARAPONGAS","SUL","PARANÁ","382.2150391",119138,51249,51211,38,"2.7"
4101606,"ARAPOTI","SUL","PARANÁ","1358.1756634",25777,10775,10756,19,"2.8"
4101655,"ARAPUÃ","SUL","PARANÁ","217.3708522",3527,1629,1629,0,"2.6"
4101705,"ARARUNA","SUL","PARANÁ","493.1906646",14485,6556,6555,1,"2.7"
4101804,"ARAUCÁRIA","SUL","PARANÁ","469.2401842",151666,63178,63143,35,"2.8"
4101853,"ARIRANHA DO IVAÍ","SUL","PARANÁ","234.0754913",2329,1163,1163,0,"2.6"
4101903,"ASSAÍ","SUL","PARANÁ","440.3471082",13797,6654,6651,3,"2.7"
4102000,"ASSIS CHATEAUBRIAND","SUL","PARANÁ","980.7266778",36808,15807,15791,16,"2.6"
4102109,"ASTORGA","SUL","PARANÁ","434.7916428",25475,11233,11229,4,"2.7"
4102208,"ATALAIA","SUL","PARANÁ","137.663384",3980,1752,1750,2,"2.6"
4102307,"BALSA NOVA","SUL","PARANÁ","348.9258423",13395,6019,6012,7,"2.8"
4102406,"BANDEIRANTES","SUL","PARANÁ","445.1924322",31273,13876,13860,16,"2.8"
4102505,"BARBOSA FERRAZ","SUL","PARANÁ","538.6358197",10795,5358,5352,6,"2.5"
4102604,"BARRACÃO","SUL","PARANÁ","161.2130019",9759,4101,4098,3,"2.7"
4102703,"BARRA DO JACARÉ","SUL","PARANÁ","115.8549117",2814,1291,1291,0,"2.7"
4102752,"BELA VISTA DA CAROBA","SUL","PARANÁ","148.1066838",4031,1541,1541,0,"2.8"
4102802,"BELA VISTA DO PARAÍSO","SUL","PARANÁ","242.6894536",14833,6757,6754,3,"2.7"
4102901,"BITURUNA","SUL","PARANÁ","1234.9463626",15533,6564,6558,6,"3"
4103008,"BOA ESPERANÇA","SUL","PARANÁ","302.7385384",4558,1985,1985,0,"2.6"
4103024,"BOA ESPERANÇA DO IGUAÇU","SUL","PARANÁ","151.7973773",2455,1087,1086,1,"2.8"
4103040,"BOA VENTURA DE SÃO ROQUE","SUL","PARANÁ","620.4530048",6378,2729,2729,0,"2.8"
4103057,"BOA VISTA DA APARECIDA","SUL","PARANÁ","266.174849",7924,4401,4399,2,"2.7"
4103107,"BOCAIÚVA DO SUL","SUL","PARANÁ","825.6651573",13299,6610,6595,15,"2.9"
4103156,"BOM JESUS DO SUL","SUL","PARANÁ","176.1290494",3980,1807,1807,0,"2.6"
4103206,"BOM SUCESSO","SUL","PARANÁ","322.7554858",6581,2833,2830,3,"2.7"
4103222,"BOM SUCESSO DO SUL","SUL","PARANÁ","195.9309605",3202,1332,1332,0,"2.7"
4103305,"BORRAZÓPOLIS","SUL","PARANÁ","334.3775763",7735,3800,3798,2,"2.5"
4103354,"BRAGANEY","SUL","PARANÁ","343.3211518",4854,2285,2284,1,"2.6"
4103370,"BRASILÂNDIA DO SUL","SUL","PARANÁ","291.0357484",3708,1702,1702,0,"2.6"
4103404,"CAFEARA","SUL","PARANÁ","185.7999145",2627,1220,1220,0,"2.6"
4103453,"CAFELÂNDIA","SUL","PARANÁ","274.9044292",18997,7381,7379,2,"2.8"
4103479,"CAFEZAL DO SUL","SUL","PARANÁ","335.3922674",4473,2115,2115,0,"2.6"
4103503,"CALIFÓRNIA","SUL","PARANÁ","141.8167088",8710,3934,3932,2,"2.7"
4103602,"CAMBARÁ","SUL","PARANÁ","366.1533777",23212,9864,9855,9,"2.8"
4103701,"CAMBÉ","SUL","PARANÁ","495.375387",107208,45353,45337,16,"2.7"
4103800,"CAMBIRA","SUL","PARANÁ","164.7864507",9460,4182,4181,1,"2.7"
4103909,"CAMPINA DA LAGOA","SUL","PARANÁ","796.6143337",15723,6972,6970,2,"2.6"
4103958,"CAMPINA DO SIMÃO","SUL","PARANÁ","448.4240371",3936,1809,1807,2,"2.9"
4104006,"CAMPINA GRANDE DO SUL","SUL","PARANÁ","539.2446764",47825,20892,20872,20,"2.8"
4104055,"CAMPO BONITO","SUL","PARANÁ","433.8319775",4027,1763,1763,0,"2.7"
4104105,"CAMPO DO TENENTE","SUL","PARANÁ","304.4882002",7508,3117,3114,3,"3"
4104204,"CAMPO LARGO","SUL","PARANÁ","1243.5510475",136327,58179,58146,33,"2.8"
4104253,"CAMPO MAGRO","SUL","PARANÁ","275.3522416",30160,12463,12459,4,"2.8"
4104303,"CAMPO MOURÃO","SUL","PARANÁ","749.6374493",99432,43415,43368,47,"2.6"
4104402,"CÂNDIDO DE ABREU","SUL","PARANÁ","1510.1597835",15244,6911,6908,3,"2.7"
4104428,"CANDÓI","SUL","PARANÁ","1512.7858089",14973,6808,6802,6,"2.8"
4104451,"CANTAGALO","SUL","PARANÁ","583.3043764",10933,4640,4632,8,"2.8"
4104501,"CAPANEMA","SUL","PARANÁ","419.0361299",20481,8409,8402,7,"2.6"
4104600,"CAPITÃO LEÔNIDAS MARQUES","SUL","PARANÁ","280.0630099",14648,6664,6661,3,"2.7"
4104659,"CARAMBEÍ","SUL","PARANÁ","649.6794945",23283,9550,9543,7,"2.9"
4104709,"CARLÓPOLIS","SUL","PARANÁ","451.4183747",16905,8063,8054,9,"2.7"
4104808,"CASCAVEL","SUL","PARANÁ","2091.1989445",348051,146881,146795,86,"2.7"
4104907,"CASTRO","SUL","PARANÁ","2531.5026265",73075,30585,30561,24,"2.9"
4105003,"CATANDUVAS","SUL","PARANÁ","580.4214227",10446,3832,3823,9,"3.1"
4105102,"CENTENÁRIO DO SUL","SUL","PARANÁ","371.8338033",10832,5227,5223,4,"2.5"
4105201,"CERRO AZUL","SUL","PARANÁ","1341.1892086",16134,7924,7920,4,"2.8"
4105300,"CÉU AZUL","SUL","PARANÁ","1179.4493848",11087,4748,4745,3,"2.6"
4105409,"CHOPINZINHO","SUL","PARANÁ","959.6922395",21085,9336,9328,8,"2.7"
4105508,"CIANORTE","SUL","PARANÁ","811.6654906",79527,34085,34071,14,"2.7"
4105607,"CIDADE GAÚCHA","SUL","PARANÁ","403.0450657",11467,4984,4975,9,"2.7"
4105706,"CLEVELÂNDIA","SUL","PARANÁ","703.6379208",15070,6729,6726,3,"2.8"
4105805,"COLOMBO","SUL","PARANÁ","197.580196",232212,92405,92378,27,"2.8"
4105904,"COLORADO","SUL","PARANÁ","407.5678219",22896,10243,10233,10,"2.6"
4106001,"CONGONHINHAS","SUL","PARANÁ","535.9629002",8320,4063,4060,3,"2.6"
4106100,"CONSELHEIRO MAIRINCK","SUL","PARANÁ","204.7051896",3461,1647,1645,2,"2.6"
4106209,"CONTENDA","SUL","PARANÁ","299.0367227",19128,8360,8356,4,"2.8"
4106308,"CORBÉLIA","SUL","PARANÁ","529.13718",17470,7288,7280,8,"2.7"
4106407,"CORNÉLIO PROCÓPIO","SUL","PARANÁ","635.1001062",45206,21294,21271,23,"2.6"
4106456,"CORONEL DOMINGOS SOARES","SUL","PARANÁ","1556.1864329",5649,2698,2686,12,"2.8"
4106506,"CORONEL VIVIDA","SUL","PARANÁ","684.4167231",23331,9930,9928,2,"2.7"
4106555,"CORUMBATAÍ DO SUL","SUL","PARANÁ","164.3410938",3760,1772,1771,1,"2.6"
4106571,"CRUZEIRO DO IGUAÇU","SUL","PARANÁ","161.862173",4133,2003,2001,2,"2.7"
4106605,"CRUZEIRO DO OESTE","SUL","PARANÁ","775.9843063",23831,10435,10410,25,"2.6"
4106704,"CRUZEIRO DO SUL","SUL","PARANÁ","259.1025489",4494,2105,2104,1,"2.6"
4106803,"CRUZ MACHADO","SUL","PARANÁ","1478.3503668",15978,7292,7287,5,"2.8"
4106852,"CRUZMALTINA","SUL","PARANÁ","312.2987495",2892,1419,1417,2,"2.7"
4106902,"CURITIBA","SUL","PARANÁ","434.8920969",1773718,789846,788684,1162,"2.6"
4107009,"CURIÚVA","SUL","PARANÁ","576.2628908",13647,6135,6128,7,"2.7"
4107108,"DIAMANTE DO NORTE","SUL","PARANÁ","242.8865972",5142,2206,2203,3,"2.7"
4107124,"DIAMANTE DO SUL","SUL","PARANÁ","347.2325625",3171,1596,1596,0,"2.7"
4107157,"DIAMANTE D'OESTE","SUL","PARANÁ","309.1098008",4557,2073,2072,1,"2.7"
4107207,"DOIS VIZINHOS","SUL","PARANÁ","418.648243",44869,19013,19002,11,"2.6"
4107256,"DOURADINA","SUL","PARANÁ","420.6035478",9161,4005,4003,2,"2.6"
4107306,"DOUTOR CAMARGO","SUL","PARANÁ","118.2785947",6327,3296,3292,4,"2.5"
4107405,"ENÉAS MARQUES","SUL","PARANÁ","192.2034048",5999,2679,2678,1,"2.7"
4107504,"ENGENHEIRO BELTRÃO","SUL","PARANÁ","467.4699433",12454,5914,5909,5,"2.6"
4107520,"ESPERANÇA NOVA","SUL","PARANÁ","141.2856712",1849,916,915,1,"2.6"
4107538,"ENTRE RIOS DO OESTE","SUL","PARANÁ","120.9670074",4575,1852,1852,0,"2.7"
4107546,"ESPIGÃO ALTO DO IGUAÇU","SUL","PARANÁ","326.4403895",4797,2051,2050,1,"2.8"
4107553,"FAROL","SUL","PARANÁ","289.2318833",3039,1357,1357,0,"2.7"
4107603,"FAXINAL","SUL","PARANÁ","715.9430818",16389,7316,7302,14,"2.7"
4107652,"FAZENDA RIO GRANDE","SUL","PARANÁ","116.67754",148873,57907,57886,21,"2.9"
4107702,"FÊNIX","SUL","PARANÁ","234.0994384",4492,2104,2102,2,"2.5"
4107736,"FERNANDES PINHEIRO","SUL","PARANÁ","406.4995521",6255,2629,2628,1,"2.9"
4107751,"FIGUEIRA","SUL","PARANÁ","129.7692887",8062,3633,3631,2,"2.7"
4107801,"FLORAÍ","SUL","PARANÁ","191.1332693",4792,2407,2406,1,"2.5"
4107850,"FLOR DA SERRA DO SUL","SUL","PARANÁ","255.7211523",4364,1907,1907,0,"2.7"
4107900,"FLORESTA","SUL","PARANÁ","158.2256621",10458,4892,4889,3,"2.7"
4108007,"FLORESTÓPOLIS","SUL","PARANÁ","246.8531786",11446,5138,5130,8,"2.7"
4108106,"FLÓRIDA","SUL","PARANÁ","83.0457337",2652,1246,1246,0,"2.7"
4108205,"FORMOSA DO OESTE","SUL","PARANÁ","275.9005691",7635,3631,3629,2,"2.5"
4108304,"FOZ DO IGUAÇU","SUL","PARANÁ","609.1921408",285415,116648,116539,109,"2.8"
4108320,"FRANCISCO ALVES","SUL","PARANÁ","321.8983336",8116,3379,3378,1,"2.8"
4108403,"FRANCISCO BELTRÃO","SUL","PARANÁ","735.1105833",96666,41227,41190,37,"2.6"
4108452,"FOZ DO JORDÃO","SUL","PARANÁ","235.3824407",4926,2401,2399,2,"2.8"
4108502,"GENERAL CARNEIRO","SUL","PARANÁ","1071.1831288",11062,4698,4691,7,"2.9"
4108551,"GODOY MOREIRA","SUL","PARANÁ","131.0115794",2977,1582,1580,2,"2.5"
4108601,"GOIOERÊ","SUL","PARANÁ","564.1633896",28437,12319,12314,5,"2.6"
4108650,"GOIOXIM","SUL","PARANÁ","702.4706095",6566,2910,2909,1,"2.8"
4108700,"GRANDES RIOS","SUL","PARANÁ","314.1983933",5641,2816,2814,2,"2.6"
4108809,"GUAÍRA","SUL","PARANÁ","563.7415496",32097,13812,13793,19,"2.7"
4108908,"GUAIRAÇÁ","SUL","PARANÁ","493.9399759",6587,2831,2829,2,"2.7"
4108957,"GUAMIRANGA","SUL","PARANÁ","244.7945076",7856,3313,3310,3,"2.8"
4109005,"GUAPIRAMA","SUL","PARANÁ","189.0995448",4626,2147,2146,1,"2.7"
4109104,"GUAPOREMA","SUL","PARANÁ","201.1498277",2191,1018,1017,1,"2.6"
4109203,"GUARACI","SUL","PARANÁ","211.6799125",4748,2155,2154,1,"2.6"
4109302,"GUARANIAÇU","SUL","PARANÁ","1238.3197651",13735,6730,6726,4,"2.6"
4109401,"GUARAPUAVA","SUL","PARANÁ","3168.0871506",182093,76563,76491,72,"2.8"
4109500,"GUARAQUEÇABA","SUL","PARANÁ","2011.3571697",7430,4488,4446,42,"2.9"
4109609,"GUARATUBA","SUL","PARANÁ","1326.6699146",42062,35797,35732,65,"2.7"
4109658,"HONÓRIO SERPA","SUL","PARANÁ","502.2141148",4941,2240,2236,4,"2.8"
4109708,"IBAITI","SUL","PARANÁ","898.2209235",28830,12922,12910,12,"2.7"
4109757,"IBEMA","SUL","PARANÁ","145.4463576",6218,2716,2714,2,"2.6"
4109807,"IBIPORÃ","SUL","PARANÁ","297.7418416",51603,23227,23214,13,"2.7"
4109906,"ICARAÍMA","SUL","PARANÁ","675.240378",8991,4440,4433,7,"2.7"
4110003,"IGUARAÇU","SUL","PARANÁ","164.9831166",5338,2634,2633,1,"2.7"
4110052,"IGUATU","SUL","PARANÁ","106.9374054",2144,1000,1000,0,"2.6"
4110078,"IMBAÚ","SUL","PARANÁ","330.7340333",14249,5360,5350,10,"3"
4110102,"IMBITUVA","SUL","PARANÁ","756.5348413",29924,11723,11716,7,"2.9"
4110201,"INÁCIO MARTINS","SUL","PARANÁ","936.2080572",9670,4211,4207,4,"2.9"
4110300,"INAJÁ","SUL","PARANÁ","194.7042486",2536,1221,1218,3,"2.5"
4110409,"INDIANÓPOLIS","SUL","PARANÁ","122.6219901",4448,2093,2092,1,"2.7"
4110508,"IPIRANGA","SUL","PARANÁ","900.7213173",14142,5923,5916,7,"2.9"
4110607,"IPORÃ","SUL","PARANÁ","647.8942",15746,6845,6832,13,"2.7"
4110656,"IRACEMA DO OESTE","SUL","PARANÁ","81.5384286",2343,982,982,0,"2.7"
4110706,"IRATI","SUL","PARANÁ","999.5166925",59250,24578,24543,35,"2.7"
4110805,"IRETAMA","SUL","PARANÁ","570.4593184",10684,4675,4673,2,"2.7"
4110904,"ITAGUAJÉ","SUL","PARANÁ","194.3525758",4481,2290,2287,3,"2.7"
4110953,"ITAIPULÂNDIA","SUL","PARANÁ","330.8461438",11485,4590,4589,1,"2.8"
4111001,"ITAMBARACÁ","SUL","PARANÁ","207.3424026",5908,2816,2814,2,"2.7"
4111100,"ITAMBÉ","SUL","PARANÁ","243.8218012",6111,2861,2861,0,"2.6"
4111209,"ITAPEJARA D'OESTE","SUL","PARANÁ","254.0141052",12344,5108,5097,11,"2.7"
4111258,"ITAPERUÇU","SUL","PARANÁ","322.9912016",31217,11864,11861,3,"3"
4111308,"ITAÚNA DO SUL","SUL","PARANÁ","128.8696509",3572,1585,1585,0,"2.7"
4111407,"IVAÍ","SUL","PARANÁ","607.8475899",13229,5581,5574,7,"2.9"
4111506,"IVAIPORÃ","SUL","PARANÁ","436.9885973",32720,14763,14753,10,"2.6"
4111555,"IVATÉ","SUL","PARANÁ","410.1559812",6831,3318,3315,3,"2.6"
4111605,"IVATUBA","SUL","PARANÁ","96.6612619",2708,1760,1758,2,"2.5"
4111704,"JABOTI","SUL","PARANÁ","139.2771571",5427,2582,2582,0,"2.6"
4111803,"JACAREZINHO","SUL","PARANÁ","602.5284924",40375,17217,17202,15,"2.8"
4111902,"JAGUAPITÃ","SUL","PARANÁ","475.0044009",15122,6683,6679,4,"2.7"
4112009,"JAGUARIAÍVA","SUL","PARANÁ","1453.065732",35141,14995,14973,22,"2.7"
4112108,"JANDAIA DO SUL","SUL","PARANÁ","187.6002282",21408,9810,9797,13,"2.6"
4112207,"JANIÓPOLIS","SUL","PARANÁ","335.650125",5870,2758,2755,3,"2.5"
4112306,"JAPIRA","SUL","PARANÁ","187.8018132",4972,2354,2353,1,"2.7"
4112405,"JAPURÁ","SUL","PARANÁ","165.1845334",9144,3887,3887,0,"2.6"
4112504,"JARDIM ALEGRE","SUL","PARANÁ","413.3856638",12004,5432,5429,3,"2.6"
4112603,"JARDIM OLINDA","SUL","PARANÁ","128.5146959",1343,763,763,0,"2.7"
4112702,"JATAIZINHO","SUL","PARANÁ","159.1775617",11813,5241,5238,3,"2.8"
4112751,"JESUÍTAS","SUL","PARANÁ","247.4961153",10506,4319,4316,3,"2.8"
4112801,"JOAQUIM TÁVORA","SUL","PARANÁ","289.1729469",11945,5373,5366,7,"2.7"
4112900,"JUNDIAÍ DO SUL","SUL","PARANÁ","320.8158781",3333,1541,1541,0,"2.7"
4112959,"JURANDA","SUL","PARANÁ","354.3644255",7771,3401,3399,2,"2.7"
4113007,"JUSSARA","SUL","PARANÁ","210.8694023",6690,2886,2886,0,"2.7"
4113106,"KALORÉ","SUL","PARANÁ","193.2987448",4582,2181,2179,2,"2.6"
4113205,"LAPA","SUL","PARANÁ","2093.8594134",45003,21165,21142,23,"2.7"
4113254,"LARANJAL","SUL","PARANÁ","559.4390016",5600,2263,2263,0,"3"
4113304,"LARANJEIRAS DO SUL","SUL","PARANÁ","673.6885037",32227,13658,13631,27,"2.7"
4113403,"LEÓPOLIS","SUL","PARANÁ","344.9180113",3752,1941,1941,0,"2.6"
4113429,"LIDIANÓPOLIS","SUL","PARANÁ","151.4560533",3938,1876,1875,1,"2.6"
4113452,"LINDOESTE","SUL","PARANÁ","347.0934148",5175,2489,2487,2,"2.8"
4113502,"LOANDA","SUL","PARANÁ","722.4965022",23225,9824,9808,16,"2.7"
4113601,"LOBATO","SUL","PARANÁ","240.9041794",4601,2030,2030,0,"2.7"
4113700,"LONDRINA","SUL","PARANÁ","1652.5694214",555965,247287,247065,222,"2.6"
4113734,"LUIZIANA","SUL","PARANÁ","916.839078",6690,3036,3035,1,"2.7"
4113759,"LUNARDELLI","SUL","PARANÁ","199.2134592",4872,2303,2302,1,"2.6"
4113809,"LUPIONÓPOLIS","SUL","PARANÁ","121.0655672",4813,2412,2409,3,"2.6"
4113908,"MALLET","SUL","PARANÁ","760.2237724",13428,5799,5793,6,"2.7"
4114005,"MAMBORÊ","SUL","PARANÁ","788.0609563",13452,6109,6103,6,"2.6"
4114104,"MANDAGUAÇU","SUL","PARANÁ","294.0190506",31457,13210,13207,3,"2.8"
4114203,"MANDAGUARI","SUL","PARANÁ","335.8141759",36716,15633,15630,3,"2.7"
4114302,"MANDIRITUBA","SUL","PARANÁ","379.1786207",27439,13377,13362,15,"2.8"
4114351,"MANFRINÓPOLIS","SUL","PARANÁ","215.7786301",2770,1279,1279,0,"2.7"
4114401,"MANGUEIRINHA","SUL","PARANÁ","1055.4584429",16603,7277,7270,7,"2.8"
4114500,"MANOEL RIBAS","SUL","PARANÁ","571.134602",14240,5590,5581,9,"2.9"
4114609,"MARECHAL CÂNDIDO RONDON","SUL","PARANÁ","745.7479481",55836,23856,23840,16,"2.6"
4114708,"MARIA HELENA","SUL","PARANÁ","486.2237904",5865,2839,2838,1,"2.6"
4114807,"MARIALVA","SUL","PARANÁ","475.5636734",41851,18465,18457,8,"2.7"
4114906,"MARILÂNDIA DO SUL","SUL","PARANÁ","384.4244515",8677,3643,3640,3,"2.7"
4115002,"MARILENA","SUL","PARANÁ","232.3629525",7253,3932,3931,1,"2.7"
4115101,"MARILUZ","SUL","PARANÁ","433.1703205",9847,4285,4282,3,"2.7"
4115200,"MARINGÁ","SUL","PARANÁ","487.0123102",409657,180117,179976,141,"2.6"
4115309,"MARIÓPOLIS","SUL","PARANÁ","230.3651881",6371,2721,2720,1,"2.6"
4115358,"MARIPÁ","SUL","PARANÁ","283.7933304",6555,2662,2661,1,"2.8"
4115408,"MARMELEIRO","SUL","PARANÁ","387.6121539",15901,6570,6564,6,"2.7"
4115457,"MARQUINHO","SUL","PARANÁ","503.8582541",4504,2175,2174,1,"2.8"
4115507,"MARUMBI","SUL","PARANÁ","208.4697553",4699,2187,2186,1,"2.6"
4115606,"MATELÂNDIA","SUL","PARANÁ","639.7460959",18450,7309,7303,6,"2.8"
4115705,"MATINHOS","SUL","PARANÁ","117.898652",39259,44974,44881,93,"2.6"
4115739,"MATO RICO","SUL","PARANÁ","394.5333398",3267,1492,1491,1,"2.7"
4115754,"MAUÁ DA SERRA","SUL","PARANÁ","108.3243418",9383,3940,3939,1,"2.8"
4115804,"MEDIANEIRA","SUL","PARANÁ","328.7315914",54369,21642,21615,27,"2.8"
4115853,"MERCEDES","SUL","PARANÁ","197.1356286",5931,2381,2380,1,"2.8"
4115903,"MIRADOR","SUL","PARANÁ","221.7078016",2238,1021,1020,1,"2.7"
4116000,"MIRASELVA","SUL","PARANÁ","90.2939184",1966,907,907,0,"2.6"
4116059,"MISSAL","SUL","PARANÁ","324.3973503",11064,4906,4902,4,"2.7"
4116109,"MOREIRA SALES","SUL","PARANÁ","353.7719899",11175,5591,5587,4,"2.5"
4116208,"MORRETES","SUL","PARANÁ","684.5803709",18309,10006,9995,11,"2.8"
4116307,"MUNHOZ DE MELO","SUL","PARANÁ","137.0178772",3951,1781,1780,1,"2.7"
4116406,"NOSSA SENHORA DAS GRAÇAS","SUL","PARANÁ","185.7693345",3669,1688,1688,0,"2.7"
4116505,"NOVA ALIANÇA DO IVAÍ","SUL","PARANÁ","131.2719135",1323,619,619,0,"2.8"
4116604,"NOVA AMÉRICA DA COLINA","SUL","PARANÁ","129.4760907",3280,1433,1433,0,"2.8"
4116703,"NOVA AURORA","SUL","PARANÁ","470.6424718",13765,5443,5438,5,"2.8"
4116802,"NOVA CANTU","SUL","PARANÁ","555.4876306",6790,3011,3006,5,"2.7"
4116901,"NOVA ESPERANÇA","SUL","PARANÁ","401.5869596",26585,11618,11610,8,"2.7"
4116950,"NOVA ESPERANÇA DO SUDOESTE","SUL","PARANÁ","208.471713",5597,2325,2323,2,"2.7"
4117008,"NOVA FÁTIMA","SUL","PARANÁ","283.4229166",7225,3264,3264,0,"2.6"
4117057,"NOVA LARANJEIRAS","SUL","PARANÁ","1210.2047638",12074,4953,4950,3,"3"
4117107,"NOVA LONDRINA","SUL","PARANÁ","269.3887941",12923,5349,5341,8,"2.7"
4117206,"NOVA OLÍMPIA","SUL","PARANÁ","136.3474051",5833,2679,2676,3,"2.6"
4117214,"NOVA SANTA BÁRBARA","SUL","PARANÁ","76.8874126",4184,1868,1868,0,"2.6"
4117222,"NOVA SANTA ROSA","SUL","PARANÁ","204.6652868",8322,3518,3517,1,"2.7"
4117255,"NOVA PRATA DO IGUAÇU","SUL","PARANÁ","352.5649374",12699,4935,4933,2,"2.8"
4117271,"NOVA TEBAS","SUL","PARANÁ","545.6862574",6848,3148,3145,3,"2.7"
4117297,"NOVO ITACOLOMI","SUL","PARANÁ","161.4107514",3125,1435,1435,0,"2.7"
4117305,"ORTIGUEIRA","SUL","PARANÁ","2429.5198883",24192,11423,11408,15,"2.8"
4117404,"OURIZONA","SUL","PARANÁ","176.456855",3187,1458,1457,1,"2.7"
4117453,"OURO VERDE DO OESTE","SUL","PARANÁ","293.042234",6785,2893,2890,3,"2.7"
4117503,"PAIÇANDU","SUL","PARANÁ","171.3788251",45962,19074,19070,4,"2.8"
4117602,"PALMAS","SUL","PARANÁ","1557.9034306",48247,17370,17358,12,"2.9"
4117701,"PALMEIRA","SUL","PARANÁ","1470.0723389",33855,14904,14887,17,"2.8"
4117800,"PALMITAL","SUL","PARANÁ","817.6465777",13033,6097,6094,3,"2.7"
4117909,"PALOTINA","SUL","PARANÁ","651.2377421",35011,15188,15178,10,"2.8"
4118006,"PARAÍSO DO NORTE","SUL","PARANÁ","204.5639491",13245,5547,5543,4,"2.7"
4118105,"PARANACITY","SUL","PARANÁ","348.6306292",9557,4713,4708,5,"2.7"
4118204,"PARANAGUÁ","SUL","PARANÁ","822.8378343",145829,59236,59081,155,"3"
4118303,"PARANAPOEMA","SUL","PARANÁ","175.8749921",2398,1111,1109,2,"2.6"
4118402,"PARANAVAÍ","SUL","PARANÁ","1202.2657173",92001,39538,39500,38,"2.7"
4118451,"PATO BRAGADO","SUL","PARANÁ","135.6004842",5733,2397,2394,3,"2.7"
4118501,"PATO BRANCO","SUL","PARANÁ","539.1079715",91836,38922,38880,42,"2.7"
4118600,"PAULA FREITAS","SUL","PARANÁ","421.4085131",5666,2681,2681,0,"2.8"
4118709,"PAULO FRONTIN","SUL","PARANÁ","363.3511146",6343,2780,2775,5,"2.7"
4118808,"PEABIRU","SUL","PARANÁ","468.5944153",13346,5826,5824,2,"2.7"
4118857,"PEROBAL","SUL","PARANÁ","409.0496457",7189,3325,3325,0,"2.7"
4118907,"PÉROLA","SUL","PARANÁ","236.1859525",11878,5793,5785,8,"2.6"
4119004,"PÉROLA D'OESTE","SUL","PARANÁ","205.2786104",6221,2737,2735,2,"2.6"
4119103,"PIÊN","SUL","PARANÁ","254.7922908",13655,5641,5640,1,"2.9"
4119152,"PINHAIS","SUL","PARANÁ","60.8693763",127019,51243,51228,15,"2.8"
4119202,"PINHALÃO","SUL","PARANÁ","220.6254061",6566,2935,2931,4,"2.7"
4119251,"PINHAL DE SÃO BENTO","SUL","PARANÁ","97.463407",2761,1103,1103,0,"2.9"
4119301,"PINHÃO","SUL","PARANÁ","2001.5875912",29886,13830,13823,7,"2.9"
4119400,"PIRAÍ DO SUL","SUL","PARANÁ","1345.4177404",23651,10183,10166,17,"2.8"
4119509,"PIRAQUARA","SUL","PARANÁ","227.0417561",118730,43693,43633,60,"2.9"
4119608,"PITANGA","SUL","PARANÁ","1663.747218",33567,14205,14195,10,"2.7"
4119657,"PITANGUEIRAS","SUL","PARANÁ","123.2293242",3046,1251,1251,0,"2.8"
4119707,"PLANALTINA DO PARANÁ","SUL","PARANÁ","356.1915845",4070,1808,1807,1,"2.8"
4119806,"PLANALTO","SUL","PARANÁ","346.2409191",14374,5690,5686,4,"2.7"
4119905,"PONTA GROSSA","SUL","PARANÁ","2054.732261",358371,156341,156214,127,"2.8"
4119954,"PONTAL DO PARANÁ","SUL","PARANÁ","200.4102923",30425,36881,36800,81,"2.6"
4120002,"PORECATU","SUL","PARANÁ","291.6627081",11624,5206,5201,5,"2.6"
4120101,"PORTO AMAZONAS","SUL","PARANÁ","186.5806696",4098,1881,1877,4,"2.8"
4120150,"PORTO BARREIRO","SUL","PARANÁ","361.0205035",3110,1396,1395,1,"2.7"
4120200,"PORTO RICO","SUL","PARANÁ","217.6757289",3182,2792,2783,9,"2.8"
4120309,"PORTO VITÓRIA","SUL","PARANÁ","213.0128706",3562,1647,1645,2,"2.9"
4120333,"PRADO FERREIRA","SUL","PARANÁ","152.8762996",3709,1842,1840,2,"2.7"
4120358,"PRANCHITA","SUL","PARANÁ","226.139742",5737,2452,2450,2,"2.7"
4120408,"PRESIDENTE CASTELO BRANCO","SUL","PARANÁ","155.7340312",4336,1826,1826,0,"2.8"
4120507,"PRIMEIRO DE MAIO","SUL","PARANÁ","414.4417061",10082,5233,5230,3,"2.6"
4120606,"PRUDENTÓPOLIS","SUL","PARANÁ","2247.1411295",49393,21018,20989,29,"2.8"
4120655,"QUARTO CENTENÁRIO","SUL","PARANÁ","321.8749827",4201,1856,1856,0,"2.7"
4120705,"QUATIGUÁ","SUL","PARANÁ","112.6892333",8099,3626,3624,2,"2.6"
4120804,"QUATRO BARRAS","SUL","PARANÁ","180.4711511",24191,9786,9775,11,"2.9"
4120853,"QUATRO PONTES","SUL","PARANÁ","114.3925268",4480,1866,1863,3,"2.6"
4120903,"QUEDAS DO IGUAÇU","SUL","PARANÁ","821.5032056",30738,13058,13048,10,"2.7"
4121000,"QUERÊNCIA DO NORTE","SUL","PARANÁ","914.7630622",10685,5215,5206,9,"2.7"
4121109,"QUINTA DO SOL","SUL","PARANÁ","326.1768373",5001,2247,2246,1,"2.7"
4121208,"QUITANDINHA","SUL","PARANÁ","447.0236271",18398,9191,9186,5,"2.7"
4121257,"RAMILÂNDIA","SUL","PARANÁ","237.195724",4221,1781,1780,1,"2.9"
4121307,"RANCHO ALEGRE","SUL","PARANÁ","167.64586",3512,1730,1730,0,"2.5"
4121356,"RANCHO ALEGRE D'OESTE","SUL","PARANÁ","241.3863791",2618,1111,1111,0,"2.7"
4121406,"REALEZA","SUL","PARANÁ","353.4161638",19247,8178,8160,18,"2.6"
4121505,"REBOUÇAS","SUL","PARANÁ","481.8396792",14514,6235,6229,6,"2.7"
4121604,"RENASCENÇA","SUL","PARANÁ","425.2734875",6845,2911,2911,0,"2.7"
4121703,"RESERVA","SUL","PARANÁ","1635.5351415",24573,10946,10939,7,"2.7"
4121752,"RESERVA DO IGUAÇU","SUL","PARANÁ","834.2321536",6553,2945,2937,8,"2.9"
4121802,"RIBEIRÃO CLARO","SUL","PARANÁ","629.2239337",12364,6335,6328,7,"2.7"
4121901,"RIBEIRÃO DO PINHAL","SUL","PARANÁ","374.7321931",13060,6010,5986,24,"2.6"
4122008,"RIO AZUL","SUL","PARANÁ","599.0556619",14025,5846,5834,12,"2.8"
4122107,"RIO BOM","SUL","PARANÁ","177.8356869",3197,1574,1573,1,"2.5"
4122156,"RIO BONITO DO IGUAÇU","SUL","PARANÁ","681.4060082",13929,5720,5718,2,"2.9"
4122172,"RIO BRANCO DO IVAÍ","SUL","PARANÁ","376.1092112",3808,1790,1788,2,"2.8"
4122206,"RIO BRANCO DO SUL","SUL","PARANÁ","811.4247292",37558,15359,15351,8,"2.8"
4122305,"RIO NEGRO","SUL","PARANÁ","604.1384615",31324,12828,12820,8,"2.8"
4122404,"ROLÂNDIA","SUL","PARANÁ","459.0243673",71670,29315,29299,16,"2.8"
4122503,"RONCADOR","SUL","PARANÁ","742.1209309",11251,5059,5054,5,"2.6"
4122602,"RONDON","SUL","PARANÁ","555.124731",9097,3951,3951,0,"2.7"
4122651,"ROSÁRIO DO IVAÍ","SUL","PARANÁ","377.4696789",5435,2713,2709,4,"2.6"
4122701,"SABÁUDIA","SUL","PARANÁ","190.329058",8822,3951,3951,0,"2.8"
4122800,"SALGADO FILHO","SUL","PARANÁ","181.0148561",4075,1826,1824,2,"2.6"
4122909,"SALTO DO ITARARÉ","SUL","PARANÁ","200.5195602",5192,2678,2676,2,"2.6"
4123006,"SALTO DO LONTRA","SUL","PARANÁ","312.7169586",15223,5859,5858,1,"2.7"
4123105,"SANTA AMÉLIA","SUL","PARANÁ","78.0446541",3394,1583,1582,1,"2.6"
4123204,"SANTA CECÍLIA DO PAVÃO","SUL","PARANÁ","105.0755693",3365,1605,1604,1,"2.6"
4123303,"SANTA CRUZ DE MONTE CASTELO","SUL","PARANÁ","442.0131239",8613,3775,3772,3,"2.7"
4123402,"SANTA FÉ","SUL","PARANÁ","276.2410449",11378,5199,5195,4,"2.7"
4123501,"SANTA HELENA","SUL","PARANÁ","754.7007017",25492,10933,10928,5,"2.7"
4123600,"SANTA INÊS","SUL","PARANÁ","156.9349613",1748,945,944,1,"2.6"
4123709,"SANTA ISABEL DO IVAÍ","SUL","PARANÁ","349.4970994",8912,4063,4060,3,"2.6"
4123808,"SANTA IZABEL DO OESTE","SUL","PARANÁ","321.1823394",14070,5288,5287,1,"2.7"
4123824,"SANTA LÚCIA","SUL","PARANÁ","126.8129479",3644,1644,1643,1,"2.6"
4123857,"SANTA MARIA DO OESTE","SUL","PARANÁ","836.6690983",9934,4465,4462,3,"2.8"
4123907,"SANTA MARIANA","SUL","PARANÁ","427.1933247",11066,5152,5149,3,"2.6"
4123956,"SANTA MÔNICA","SUL","PARANÁ","259.9568451",3356,1553,1553,0,"2.7"
4124004,"SANTANA DO ITARARÉ","SUL","PARANÁ","251.2690619",5514,2696,2693,3,"2.6"
4124020,"SANTA TEREZA DO OESTE","SUL","PARANÁ","326.1902438",13174,5291,5290,1,"2.8"
4124053,"SANTA TEREZINHA DE ITAIPU","SUL","PARANÁ","268.2578068",24262,9621,9617,4,"2.8"
4124103,"SANTO ANTÔNIO DA PLATINA","SUL","PARANÁ","721.4718074",44369,19341,19322,19,"2.7"
4124202,"SANTO ANTÔNIO DO CAIUÁ","SUL","PARANÁ","219.067983",2493,1205,1205,0,"2.5"
4124301,"SANTO ANTÔNIO DO PARAÍSO","SUL","PARANÁ","167.0139811",2125,1066,1066,0,"2.6"
4124400,"SANTO ANTÔNIO DO SUDOESTE","SUL","PARANÁ","325.6508661",23673,8422,8414,8,"2.8"
4124509,"SANTO INÁCIO","SUL","PARANÁ","280.1327031",6181,3113,3111,2,"2.7"
4124608,"SÃO CARLOS DO IVAÍ","SUL","PARANÁ","225.0788274",6587,2746,2744,2,"2.8"
4124707,"SÃO JERÔNIMO DA SERRA","SUL","PARANÁ","823.7744335",10830,4884,4880,4,"2.7"
4124806,"SÃO JOÃO","SUL","PARANÁ","388.0590331",11886,5102,5101,1,"2.6"
4124905,"SÃO JOÃO DO CAIUÁ","SUL","PARANÁ","304.413238",5586,2523,2520,3,"2.6"
4125001,"SÃO JOÃO DO IVAÍ","SUL","PARANÁ","353.3313896",10667,5357,5351,6,"2.5"
4125100,"SÃO JOÃO DO TRIUNFO","SUL","PARANÁ","720.4074734",13726,6050,6047,3,"2.8"
4125209,"SÃO JORGE D'OESTE","SUL","PARANÁ","379.5450922",9378,4359,4357,2,"2.6"
4125308,"SÃO JORGE DO IVAÍ","SUL","PARANÁ","315.0879998",5168,2442,2440,2,"2.7"
4125357,"SÃO JORGE DO PATROCÍNIO","SUL","PARANÁ","406.4132615",6504,3034,3034,0,"2.6"
4125407,"SÃO JOSÉ DA BOA VISTA","SUL","PARANÁ","399.6673827",6040,3149,3147,2,"2.6"
4125456,"SÃO JOSÉ DAS PALMEIRAS","SUL","PARANÁ","182.4189279",3957,1755,1755,0,"2.6"
4125506,"SÃO JOSÉ DOS PINHAIS","SUL","PARANÁ","946.4349076",329628,137156,137086,70,"2.8"
4125555,"SÃO MANOEL DO PARANÁ","SUL","PARANÁ","95.3813503",2138,944,944,0,"2.6"
4125605,"SÃO MATEUS DO SUL","SUL","PARANÁ","1341.7141166",42366,18751,18731,20,"2.7"
4125704,"SÃO MIGUEL DO IGUAÇU","SUL","PARANÁ","851.9168488",29122,12068,12061,7,"2.7"
4125753,"SÃO PEDRO DO IGUAÇU","SUL","PARANÁ","308.3237742",5784,2671,2670,1,"2.6"
4125803,"SÃO PEDRO DO IVAÍ","SUL","PARANÁ","322.6919578",8690,4012,4011,1,"2.6"
4125902,"SÃO PEDRO DO PARANÁ","SUL","PARANÁ","250.6535852",2661,1637,1637,0,"2.7"
4126009,"SÃO SEBASTIÃO DA AMOREIRA","SUL","PARANÁ","226.8720596",8063,3462,3458,4,"2.7"
4126108,"SÃO TOMÉ","SUL","PARANÁ","218.6233383",5232,2478,2478,0,"2.7"
4126207,"SAPOPEMA","SUL","PARANÁ","677.6094033",6695,2983,2980,3,"2.8"
4126256,"SARANDI","SUL","PARANÁ","103.5014325",118455,49850,49844,6,"2.8"
4126272,"SAUDADE DO IGUAÇU","SUL","PARANÁ","152.0844737",6108,2681,2680,1,"2.9"
4126306,"SENGÉS","SUL","PARANÁ","1441.3325189",17270,7555,7528,27,"2.8"
4126355,"SERRANÓPOLIS DO IGUAÇU","SUL","PARANÁ","482.3944416",5007,2079,2079,0,"2.7"
4126405,"SERTANEJA","SUL","PARANÁ","444.4920719",5616,3042,3041,1,"2.6"
4126504,"SERTANÓPOLIS","SUL","PARANÁ","505.5321807",15930,7543,7541,2,"2.7"
4126603,"SIQUEIRA CAMPOS","SUL","PARANÁ","278.0347281",22811,10349,10335,14,"2.6"
4126652,"SULINA","SUL","PARANÁ","170.7594084",3440,1548,1546,2,"2.6"
4126678,"TAMARANA","SUL","PARANÁ","472.1549314",10707,4843,4841,2,"2.9"
4126702,"TAMBOARA","SUL","PARANÁ","193.3457395",4880,2220,2220,0,"2.6"
4126801,"TAPEJARA","SUL","PARANÁ","591.3986583",15869,6925,6924,1,"2.7"
4126900,"TAPIRA","SUL","PARANÁ","434.3713321",5745,2762,2761,1,"2.5"
4127007,"TEIXEIRA SOARES","SUL","PARANÁ","902.7932561",9547,4077,4072,5,"2.9"
4127106,"TELÊMACO BORBA","SUL","PARANÁ","1382.8599053",75042,30251,30168,83,"2.8"
4127205,"TERRA BOA","SUL","PARANÁ","320.849973",17568,7488,7485,3,"2.7"
4127304,"TERRA RICA","SUL","PARANÁ","700.5988499",14842,6957,6951,6,"2.7"
4127403,"TERRA ROXA","SUL","PARANÁ","800.8070239",18119,7867,7864,3,"2.7"
4127502,"TIBAGI","SUL","PARANÁ","2977.932541",19961,9059,9035,24,"2.8"
4127601,"TIJUCAS DO SUL","SUL","PARANÁ","671.8889009",17621,9643,9638,5,"2.7"
4127700,"TOLEDO","SUL","PARANÁ","1198.0489829",150470,63726,63689,37,"2.7"
4127809,"TOMAZINA","SUL","PARANÁ","591.4380107",8426,4258,4257,1,"2.6"
4127858,"TRÊS BARRAS DO PARANÁ","SUL","PARANÁ","505.5051078",11135,5492,5483,9,"2.7"
4127882,"TUNAS DO PARANÁ","SUL","PARANÁ","668.4780432",6219,2774,2764,10,"3"
4127908,"TUNEIRAS DO OESTE","SUL","PARANÁ","698.8709489",8067,3658,3658,0,"2.6"
4127957,"TUPÃSSI","SUL","PARANÁ","299.769094",8077,3421,3419,2,"2.7"
4127965,"TURVO","SUL","PARANÁ","938.9655203",14231,6091,6086,5,"2.8"
4128005,"UBIRATÃ","SUL","PARANÁ","652.5811131",24749,10487,10475,12,"2.7"
4128104,"UMUARAMA","SUL","PARANÁ","1234.5367903",117095,52387,52335,52,"2.6"
4128203,"UNIÃO DA VITÓRIA","SUL","PARANÁ","719.9978068",55033,23401,23370,31,"2.7"
4128302,"UNIFLOR","SUL","PARANÁ","94.8194376",2136,1003,1003,0,"2.7"
4128401,"URAÍ","SUL","PARANÁ","237.8097023",10406,4918,4914,4,"2.6"
4128500,"WENCESLAU BRAZ","SUL","PARANÁ","397.9160964",19188,8404,8393,11,"2.7"
4128534,"VENTANIA","SUL","PARANÁ","819.3338905",9681,4166,4160,6,"2.8"
4128559,"VERA CRUZ DO OESTE","SUL","PARANÁ","327.0899948",8215,3817,3816,1,"2.6"
4128609,"VERÊ","SUL","PARANÁ","311.8012587",7932,3412,3412,0,"2.7"
4128625,"ALTO PARAÍSO","SUL","PARANÁ","967.7718225",3055,1768,1767,1,"2.6"
4128633,"DOUTOR ULYSSES","SUL","PARANÁ","777.4817646",5697,3017,3008,9,"2.8"
4128658,"VIRMOND","SUL","PARANÁ","249.0938686",3811,1693,1693,0,"2.7"
4128708,"VITORINO","SUL","PARANÁ","308.2176463",9706,3925,3921,4,"2.8"
4128807,"XAMBRÊ","SUL","PARANÁ","359.7124693",5798,2852,2849,3,"2.6"
4200051,"ABDON BATISTA","SUL","SANTA CATARINA","237.51707",2598,1335,1335,0,"2.7"
4200101,"ABELARDO LUZ","SUL","SANTA CATARINA","953.9915661",17392,7189,7186,3,"2.9"
4200200,"AGROLÂNDIA","SUL","SANTA CATARINA","206.8154871",10990,4449,4445,4,"2.8"
4200309,"AGRONÔMICA","SUL","SANTA CATARINA","129.7741559",6055,2598,2598,0,"2.7"
4200408,"ÁGUA DOCE","SUL","SANTA CATARINA","1319.1365983",6508,3113,3106,7,"2.7"
4200507,"ÁGUAS DE CHAPECÓ","SUL","SANTA CATARINA","139.5112553",6036,2915,2906,9,"2.7"
4200556,"ÁGUAS FRIAS","SUL","SANTA CATARINA","76.6305955",2839,1206,1206,0,"2.8"
4200606,"ÁGUAS MORNAS","SUL","SANTA CATARINA","326.6600284",6743,3819,3819,0,"2.7"
4200705,"ALFREDO WAGNER","SUL","SANTA CATARINA","733.4885913",10481,5794,5791,3,"2.7"
4200754,"ALTO BELA VISTA","SUL","SANTA CATARINA","103.4330748",1856,979,979,0,"2.6"
4200804,"ANCHIETA","SUL","SANTA CATARINA","232.3484153",5943,2627,2626,1,"2.6"
4200903,"ANGELINA","SUL","SANTA CATARINA","499.9980198",5358,3128,3122,6,"2.7"
4201000,"ANITA GARIBALDI","SUL","SANTA CATARINA","589.8118108",8285,4212,4208,4,"2.6"
4201109,"ANITÁPOLIS","SUL","SANTA CATARINA","540.6361122",3593,2315,2307,8,"2.7"
4201208,"ANTÔNIO CARLOS","SUL","SANTA CATARINA","234.4217393",11224,4568,4565,3,"3"
4201257,"APIÚNA","SUL","SANTA CATARINA","493.4902474",9811,4325,4323,2,"2.8"
4201273,"ARABUTÃ","SUL","SANTA CATARINA","132.7794696",4378,1888,1887,1,"2.7"
4201307,"ARAQUARI","SUL","SANTA CATARINA","386.6926572",45283,18565,18552,13,"3"
4201406,"ARARANGUÁ","SUL","SANTA CATARINA","301.8192648",71922,32679,32653,26,"2.7"
4201505,"ARMAZÉM","SUL","SANTA CATARINA","173.9577403",8834,3859,3859,0,"2.7"
4201604,"ARROIO TRINTA","SUL","SANTA CATARINA","93.5296881",3556,1605,1604,1,"2.6"
4201653,"ARVOREDO","SUL","SANTA CATARINA","90.5034559",2510,1130,1129,1,"2.9"
4201703,"ASCURRA","SUL","SANTA CATARINA","112.883928",8319,3443,3443,0,"2.8"
4201802,"ATALANTA","SUL","SANTA CATARINA","94.3831304",3227,1412,1412,0,"2.7"
4201901,"AURORA","SUL","SANTA CATARINA","207.0448871",6780,2882,2878,4,"2.8"
4201950,"BALNEÁRIO ARROIO DO SILVA","SUL","SANTA CATARINA","94.4771894",15820,15949,15936,13,"2.6"
4202008,"BALNEÁRIO CAMBORIÚ","SUL","SANTA CATARINA","45.2138459",139155,86336,86182,154,"2.4"
4202057,"BALNEÁRIO BARRA DO SUL","SUL","SANTA CATARINA","108.9137798",14912,11580,11575,5,"2.6"
4202073,"BALNEÁRIO GAIVOTA","SUL","SANTA CATARINA","146.8336252",15669,12442,12425,17,"2.6"
4202081,"BANDEIRANTE","SUL","SANTA CATARINA","148.0738327",3144,1365,1364,1,"2.8"
4202099,"BARRA BONITA","SUL","SANTA CATARINA","92.5614157",1668,802,802,0,"2.7"
4202107,"BARRA VELHA","SUL","SANTA CATARINA","138.9467969",45369,29276,29256,20,"2.8"
4202131,"BELA VISTA DO TOLDO","SUL","SANTA CATARINA","535.6815789",5872,2454,2454,0,"2.8"
4202156,"BELMONTE","SUL","SANTA CATARINA","93.8520972",2658,1076,1076,0,"2.8"
4202206,"BENEDITO NOVO","SUL","SANTA CATARINA","388.2910194",10520,4500,4495,5,"2.8"
4202305,"BIGUAÇU","SUL","SANTA CATARINA","365.755069",76773,32950,32916,34,"2.7"
4202404,"BLUMENAU","SUL","SANTA CATARINA","518.6187164",361261,155465,155351,114,"2.6"
4202438,"BOCAINA DO SUL","SUL","SANTA CATARINA","510.6734254",3515,1918,1916,2,"2.7"
4202453,"BOMBINHAS","SUL","SANTA CATARINA","35.143211",25058,24336,24182,154,"2.7"
4202503,"BOM JARDIM DA SERRA","SUL","SANTA CATARINA","938.5164282",4026,2224,2218,6,"2.6"
4202537,"BOM JESUS","SUL","SANTA CATARINA","63.8832846",2777,1099,1098,1,"2.8"
4202578,"BOM JESUS DO OESTE","SUL","SANTA CATARINA","67.7771395",2187,862,862,0,"2.7"
4202602,"BOM RETIRO","SUL","SANTA CATARINA","1057.0340796",8418,4048,4042,6,"2.8"
4202701,"BOTUVERÁ","SUL","SANTA CATARINA","296.2559132",5363,2814,2813,1,"2.7"
4202800,"BRAÇO DO NORTE","SUL","SANTA CATARINA","212.0445495",33773,13150,13147,3,"2.8"
4202859,"BRAÇO DO TROMBUDO","SUL","SANTA CATARINA","89.4107285",4026,1684,1681,3,"2.7"
4202875,"BRUNÓPOLIS","SUL","SANTA CATARINA","336.4390249",2489,1253,1251,2,"2.7"
4202909,"BRUSQUE","SUL","SANTA CATARINA","284.6746881",141385,56269,56243,26,"2.8"
4203006,"CAÇADOR","SUL","SANTA CATARINA","983.4242159",73720,29729,29713,16,"2.8"
4203105,"CAIBI","SUL","SANTA CATARINA","173.0793895",6304,2574,2573,1,"2.7"
4203154,"CALMON","SUL","SANTA CATARINA","636.2080848",3443,1425,1424,1,"3.1"
4203204,"CAMBORIÚ","SUL","SANTA CATARINA","210.5678225",103074,41447,41431,16,"2.8"
4203253,"CAPÃO ALTO","SUL","SANTA CATARINA","1331.9623788",2625,1715,1715,0,"2.6"
4203303,"CAMPO ALEGRE","SUL","SANTA CATARINA","499.2164649",12501,6197,6185,12,"2.8"
4203402,"CAMPO BELO DO SUL","SUL","SANTA CATARINA","1025.6380579",7257,3520,3512,8,"2.7"
4203501,"CAMPO ERÊ","SUL","SANTA CATARINA","479.1611003",9623,4014,4007,7,"2.7"
4203600,"CAMPOS NOVOS","SUL","SANTA CATARINA","1717.6972448",36932,15848,15829,19,"2.7"
4203709,"CANELINHA","SUL","SANTA CATARINA","151.0080897",12821,5798,5797,1,"2.9"
4203808,"CANOINHAS","SUL","SANTA CATARINA","1148.0361634",55016,22592,22569,23,"2.8"
4203907,"CAPINZAL","SUL","SANTA CATARINA","244.0574174",23314,10318,10311,7,"2.6"
4203956,"CAPIVARI DE BAIXO","SUL","SANTA CATARINA","53.2223981",23975,9480,9472,8,"2.8"
4204004,"CATANDUVAS","SUL","SANTA CATARINA","199.1663192",10566,4282,4280,2,"2.8"
4204103,"CAXAMBU DO SUL","SUL","SANTA CATARINA","140.873183",4614,2110,2110,0,"2.8"
4204152,"CELSO RAMOS","SUL","SANTA CATARINA","208.3910897",2805,1355,1354,1,"2.7"
4204178,"CERRO NEGRO","SUL","SANTA CATARINA","418.5444604",3317,1604,1602,2,"2.8"
4204194,"CHAPADÃO DO LAGEADO","SUL","SANTA CATARINA","124.8657482",2950,1353,1352,1,"2.7"
4204202,"CHAPECÓ","SUL","SANTA CATARINA","624.8460703",254785,101916,101830,86,"2.7"
4204251,"COCAL DO SUL","SUL","SANTA CATARINA","70.965294",17240,6992,6991,1,"2.8"
4204301,"CONCÓRDIA","SUL","SANTA CATARINA","799.1944043",81646,34778,34744,34,"2.7"
4204350,"CORDILHEIRA ALTA","SUL","SANTA CATARINA","83.5560408",4781,1883,1883,0,"2.9"
4204400,"CORONEL FREITAS","SUL","SANTA CATARINA","233.6981036",10388,4258,4254,4,"2.8"
4204459,"CORONEL MARTINS","SUL","SANTA CATARINA","107.5019062",2065,917,916,1,"2.7"
4204509,"CORUPÁ","SUL","SANTA CATARINA","405.7607367",15267,6301,6295,6,"2.8"
4204558,"CORREIA PINTO","SUL","SANTA CATARINA","647.3877762",15727,6972,6966,6,"2.8"
4204608,"CRICIÚMA","SUL","SANTA CATARINA","234.8646182",214493,91348,91284,64,"2.7"
4204707,"CUNHA PORÃ","SUL","SANTA CATARINA","220.0992033",10953,4637,4632,5,"2.6"
4204756,"CUNHATAÍ","SUL","SANTA CATARINA","54.8109097",1968,774,774,0,"2.8"
4204806,"CURITIBANOS","SUL","SANTA CATARINA","949.8654886",40045,17071,17055,16,"2.8"
4204905,"DESCANSO","SUL","SANTA CATARINA","287.0568813",8530,3612,3608,4,"2.7"
4205001,"DIONÍSIO CERQUEIRA","SUL","SANTA CATARINA","378.8427328",15008,6710,6702,8,"2.7"
4205100,"DONA EMMA","SUL","SANTA CATARINA","178.1567441",4221,1742,1742,0,"2.9"
4205159,"DOUTOR PEDRINHO","SUL","SANTA CATARINA","374.2053481",3637,1719,1716,3,"2.7"
4205175,"ENTRE RIOS","SUL","SANTA CATARINA","103.8880865",3402,1347,1347,0,"2.9"
4205191,"ERMO","SUL","SANTA CATARINA","65.3112163",2269,937,936,1,"2.8"
4205209,"ERVAL VELHO","SUL","SANTA CATARINA","208.8411323",4885,2362,2358,4,"2.6"
4205308,"FAXINAL DOS GUEDES","SUL","SANTA CATARINA","340.0696362",11192,4576,4575,1,"2.8"
4205357,"FLOR DO SERTÃO","SUL","SANTA CATARINA","58.4574952",1783,804,804,0,"2.7"
4205407,"FLORIANÓPOLIS","SUL","SANTA CATARINA","674.8437956",537211,285000,284234,766,"2.4"
4205431,"FORMOSA DO SUL","SUL","SANTA CATARINA","100.4075958",2682,1032,1030,2,"2.8"
4205456,"FORQUILHINHA","SUL","SANTA CATARINA","183.3505378",31431,11853,11849,4,"2.9"
4205506,"FRAIBURGO","SUL","SANTA CATARINA","549.1881341",33481,13631,13627,4,"2.8"
4205555,"FREI ROGÉRIO","SUL","SANTA CATARINA","158.774955",2411,997,997,0,"2.8"
4205605,"GALVÃO","SUL","SANTA CATARINA","139.836313",3210,1337,1335,2,"2.7"
4205704,"GAROPABA","SUL","SANTA CATARINA","114.7725468",29959,18367,18183,184,"2.6"
4205803,"GARUVA","SUL","SANTA CATARINA","503.5946324",18545,7610,7602,8,"3"
4205902,"GASPAR","SUL","SANTA CATARINA","386.6155326",72570,28849,28832,17,"2.8"
4206009,"GOVERNADOR CELSO RAMOS","SUL","SANTA CATARINA","127.5563914",16915,12912,12891,21,"2.7"
4206108,"GRÃO-PARÁ","SUL","SANTA CATARINA","334.3618727",6277,2669,2669,0,"2.9"
4206207,"GRAVATAL","SUL","SANTA CATARINA","165.7181049",12435,5631,5621,10,"2.7"
4206306,"GUABIRUBA","SUL","SANTA CATARINA","172.1734574",24543,9545,9545,0,"2.9"
4206405,"GUARACIABA","SUL","SANTA CATARINA","331.7661781",10796,4575,4573,2,"2.7"
4206504,"GUARAMIRIM","SUL","SANTA CATARINA","267.5141642",46711,17928,17915,13,"2.9"
4206603,"GUARUJÁ DO SUL","SUL","SANTA CATARINA","100.6299523",4829,2209,2207,2,"2.5"
4206652,"GUATAMBÚ","SUL","SANTA CATARINA","206.1958222",8425,3676,3676,0,"2.9"
4206702,"HERVAL D'OESTE","SUL","SANTA CATARINA","216.5806658",21724,9144,9142,2,"2.6"
4206751,"IBIAM","SUL","SANTA CATARINA","146.0091071",2008,854,854,0,"2.8"
4206801,"IBICARÉ","SUL","SANTA CATARINA","156.438568",3269,1574,1573,1,"2.6"
4206900,"IBIRAMA","SUL","SANTA CATARINA","247.1017822",19862,8288,8282,6,"2.7"
4207007,"IÇARA","SUL","SANTA CATARINA","230.3931785",59035,23767,23755,12,"2.8"
4207106,"ILHOTA","SUL","SANTA CATARINA","253.0241594",17046,6892,6889,3,"2.9"
4207205,"IMARUÍ","SUL","SANTA CATARINA","542.2383082",11881,7305,7300,5,"2.6"
4207304,"IMBITUBA","SUL","SANTA CATARINA","181.5770026",52579,31117,30772,345,"2.6"
4207403,"IMBUIA","SUL","SANTA CATARINA","119.1134879",5982,2678,2675,3,"2.7"
4207502,"INDAIAL","SUL","SANTA CATARINA","430.7985392",71549,29447,29436,11,"2.8"
4207577,"IOMERÊ","SUL","SANTA CATARINA","113.9860208",2877,1399,1397,2,"2.7"
4207601,"IPIRA","SUL","SANTA CATARINA","155.651476",4578,2288,2287,1,"2.5"
4207650,"IPORÃ DO OESTE","SUL","SANTA CATARINA","200.9598445",9335,3731,3729,2,"2.7"
4207684,"IPUAÇU","SUL","SANTA CATARINA","261.0806178",7730,2900,2899,1,"3.1"
4207700,"IPUMIRIM","SUL","SANTA CATARINA","245.9211795",7816,3101,3101,0,"2.8"
4207759,"IRACEMINHA","SUL","SANTA CATARINA","165.1469882",3986,1683,1683,0,"2.7"
4207809,"IRANI","SUL","SANTA CATARINA","325.862472",10195,4330,4323,7,"2.8"
4207858,"IRATI","SUL","SANTA CATARINA","77.9116437",2069,885,885,0,"2.6"
4207908,"IRINEÓPOLIS","SUL","SANTA CATARINA","589.6982598",10285,4190,4186,4,"2.8"
4208005,"ITÁ","SUL","SANTA CATARINA","166.2649162",7067,3245,3236,9,"2.6"
4208104,"ITAIÓPOLIS","SUL","SANTA CATARINA","1297.5428981",22051,9367,9363,4,"2.9"
4208203,"ITAJAÍ","SUL","SANTA CATARINA","289.2151465",264054,107166,107086,80,"2.8"
4208302,"ITAPEMA","SUL","SANTA CATARINA","58.2103733",75940,51829,51540,289,"2.8"
4208401,"ITAPIRANGA","SUL","SANTA CATARINA","281.7822922",16638,6776,6772,4,"2.8"
4208450,"ITAPOÁ","SUL","SANTA CATARINA","245.3939852",30750,26791,26757,34,"2.7"
4208500,"ITUPORANGA","SUL","SANTA CATARINA","336.5880451",26525,10989,10975,14,"2.8"
4208609,"JABORÁ","SUL","SANTA CATARINA","182.4827508",4310,1795,1792,3,"2.8"
4208708,"JACINTO MACHADO","SUL","SANTA CATARINA","430.7037378",10624,4807,4807,0,"2.7"
4208807,"JAGUARUNA","SUL","SANTA CATARINA","326.3619164",20375,24733,24726,7,"2.7"
4208906,"JARAGUÁ DO SUL","SUL","SANTA CATARINA","530.8942203",182660,74571,74491,80,"2.7"
4208955,"JARDINÓPOLIS","SUL","SANTA CATARINA","68.4992554",1776,753,753,0,"2.6"
4209003,"JOAÇABA","SUL","SANTA CATARINA","241.6365687",30146,13581,13563,18,"2.5"
4209102,"JOINVILLE","SUL","SANTA CATARINA","1127.9471311",616317,248605,248424,181,"2.8"
4209151,"JOSÉ BOITEUX","SUL","SANTA CATARINA","405.5520979",5985,2351,2349,2,"3.2"
4209177,"JUPIÁ","SUL","SANTA CATARINA","91.4479815",2555,1080,1080,0,"2.7"
4209201,"LACERDÓPOLIS","SUL","SANTA CATARINA","69.0358968",2248,933,933,0,"2.7"
4209300,"LAGES","SUL","SANTA CATARINA","2637.6602464",164981,71163,71107,56,"2.7"
4209409,"LAGUNA","SUL","SANTA CATARINA","333.2594775",42785,27674,27625,49,"2.6"
4209458,"LAJEADO GRANDE","SUL","SANTA CATARINA","65.3475426",1702,649,648,1,"2.9"
4209508,"LAURENTINO","SUL","SANTA CATARINA","79.3331587",7932,3273,3270,3,"2.7"
4209607,"LAURO MÜLLER","SUL","SANTA CATARINA","271.8520994",14381,6322,6319,3,"2.7"
4209706,"LEBON RÉGIS","SUL","SANTA CATARINA","941.6403054",11472,4837,4828,9,"3"
4209805,"LEOBERTO LEAL","SUL","SANTA CATARINA","293.6003514",3330,1613,1611,2,"2.7"
4209854,"LINDÓIA DO SUL","SUL","SANTA CATARINA","190.1705031",4549,1899,1897,2,"2.8"
4209904,"LONTRAS","SUL","SANTA CATARINA","197.5859034",12873,5437,5436,1,"2.8"
4210001,"LUIZ ALVES","SUL","SANTA CATARINA","260.1062146",11684,4827,4827,0,"2.9"
4210035,"LUZERNA","SUL","SANTA CATARINA","117.0989508",5794,2740,2739,1,"2.5"
4210050,"MACIEIRA","SUL","SANTA CATARINA","261.2078226",1778,846,846,0,"2.7"
4210100,"MAFRA","SUL","SANTA CATARINA","1404.0838851",55286,24042,24029,13,"2.7"
4210209,"MAJOR GERCINO","SUL","SANTA CATARINA","306.0580602",3214,1866,1865,1,"2.7"
4210308,"MAJOR VIEIRA","SUL","SANTA CATARINA","520.815954",7425,3222,3221,1,"2.8"
4210407,"MARACAJÁ","SUL","SANTA CATARINA","62.9015611",7815,3046,3043,3,"2.8"
4210506,"MARAVILHA","SUL","SANTA CATARINA","170.3387848",28251,11841,11835,6,"2.6"
4210555,"MAREMA","SUL","SANTA CATARINA","104.1838413",2184,873,873,0,"2.9"
4210605,"MASSARANDUBA","SUL","SANTA CATARINA","374.4588211",17162,7084,7062,22,"2.8"
4210704,"MATOS COSTA","SUL","SANTA CATARINA","435.3907394",2761,1184,1183,1,"2.9"
4210803,"MELEIRO","SUL","SANTA CATARINA","186.4392356",7006,2978,2971,7,"2.7"
4210852,"MIRIM DOCE","SUL","SANTA CATARINA","337.9913469",2511,1109,1107,2,"2.8"
4210902,"MODELO","SUL","SANTA CATARINA","92.3460732",4080,1697,1696,1,"2.7"
4211009,"MONDAÍ","SUL","SANTA CATARINA","200.27564",10066,4326,4324,2,"2.7"
4211058,"MONTE CARLO","SUL","SANTA CATARINA","191.2779978",9117,3507,3504,3,"2.9"
4211108,"MONTE CASTELO","SUL","SANTA CATARINA","560.7430004",7736,3267,3263,4,"2.9"
4211207,"MORRO DA FUMAÇA","SUL","SANTA CATARINA","82.8184762",18537,7275,7274,1,"2.9"
4211256,"MORRO GRANDE","SUL","SANTA CATARINA","260.1433522",3010,1415,1415,0,"2.8"
4211306,"NAVEGANTES","SUL","SANTA CATARINA","111.3765273",86401,41121,41091,30,"2.9"
4211405,"NOVA ERECHIM","SUL","SANTA CATARINA","65.0868678",5155,1956,1955,1,"2.8"
4211454,"NOVA ITABERABA","SUL","SANTA CATARINA","137.3884412",4536,1950,1950,0,"2.7"
4211504,"NOVA TRENTO","SUL","SANTA CATARINA","402.8523903",13727,6325,6319,6,"2.7"
4211603,"NOVA VENEZA","SUL","SANTA CATARINA","295.063084",13664,5675,5667,8,"2.8"
4211652,"NOVO HORIZONTE","SUL","SANTA CATARINA","151.7222495",2643,1079,1079,0,"2.9"
4211702,"ORLEANS","SUL","SANTA CATARINA","549.8592651",23661,10036,10032,4,"2.8"
4211751,"OTACÍLIO COSTA","SUL","SANTA CATARINA","847.2528032",17312,7368,7362,6,"2.7"
4211801,"OURO","SUL","SANTA CATARINA","213.5428446",7032,3136,3135,1,"2.6"
4211850,"OURO VERDE","SUL","SANTA CATARINA","188.5676397",2181,936,936,0,"2.8"
4211876,"PAIAL","SUL","SANTA CATARINA","86.0483969",1927,908,908,0,"2.8"
4211892,"PAINEL","SUL","SANTA CATARINA","738.3307022",2215,1496,1494,2,"2.6"
4211900,"PALHOÇA","SUL","SANTA CATARINA","394.8497883",222598,105851,105631,220,"2.7"
4212007,"PALMA SOLA","SUL","SANTA CATARINA","330.8779472",7605,3160,3159,1,"2.7"
4212056,"PALMEIRA","SUL","SANTA CATARINA","289.0973252",2561,1577,1577,0,"2.7"
4212106,"PALMITOS","SUL","SANTA CATARINA","351.0511821",15626,6981,6970,11,"2.6"
4212205,"PAPANDUVA","SUL","SANTA CATARINA","764.7373202",19150,8198,8195,3,"2.8"
4212239,"PARAÍSO","SUL","SANTA CATARINA","180.3376587",4267,1987,1985,2,"2.7"
4212254,"PASSO DE TORRES","SUL","SANTA CATARINA","92.6380611",12897,9694,9677,17,"2.7"
4212270,"PASSOS MAIA","SUL","SANTA CATARINA","617.0923554",4034,1610,1609,1,"3"
4212304,"PAULO LOPES","SUL","SANTA CATARINA","446.164772",9063,4635,4627,8,"2.7"
4212403,"PEDRAS GRANDES","SUL","SANTA CATARINA","159.8915247",4245,1987,1987,0,"2.7"
4212502,"PENHA","SUL","SANTA CATARINA","57.7519848",33663,20728,20642,86,"2.8"
4212601,"PERITIBA","SUL","SANTA CATARINA","96.1681082",2992,1369,1368,1,"2.5"
4212650,"PESCARIA BRAVA","SUL","SANTA CATARINA","106.8533603",10190,4422,4418,4,"2.7"
4212700,"PETROLÂNDIA","SUL","SANTA CATARINA","306.760487",6716,2925,2924,1,"2.7"
4212809,"BALNEÁRIO PIÇARRAS","SUL","SANTA CATARINA","99.3552113",27127,19103,19096,7,"2.7"
4212908,"PINHALZINHO","SUL","SANTA CATARINA","128.725994",21972,8521,8516,5,"2.7"
4213005,"PINHEIRO PRETO","SUL","SANTA CATARINA","61.0112597",3473,1325,1325,0,"3"
4213104,"PIRATUBA","SUL","SANTA CATARINA","146.0879744",5769,3591,3571,20,"2.5"
4213153,"PLANALTO ALEGRE","SUL","SANTA CATARINA","63.1003082",2946,1222,1222,0,"2.8"
4213203,"POMERODE","SUL","SANTA CATARINA","214.2993094",34289,13056,13029,27,"2.9"
4213302,"PONTE ALTA","SUL","SANTA CATARINA","575.1698914",4437,2154,2153,1,"2.8"
4213351,"PONTE ALTA DO NORTE","SUL","SANTA CATARINA","396.8820875",3210,1292,1291,1,"3"
4213401,"PONTE SERRADA","SUL","SANTA CATARINA","560.7306883",10649,4354,4348,6,"2.8"
4213500,"PORTO BELO","SUL","SANTA CATARINA","93.6734773",27688,15093,15062,31,"2.8"
4213609,"PORTO UNIÃO","SUL","SANTA CATARINA","848.7792254",32970,13706,13685,21,"2.8"
4213708,"POUSO REDONDO","SUL","SANTA CATARINA","356.5387275",17123,6769,6764,5,"2.8"
4213807,"PRAIA GRANDE","SUL","SANTA CATARINA","284.3597247",8270,3999,3947,52,"2.5"
4213906,"PRESIDENTE CASTELLO BRANCO","SUL","SANTA CATARINA","65.4330916",1689,688,688,0,"2.8"
4214003,"PRESIDENTE GETÚLIO","SUL","SANTA CATARINA","297.1600048",20010,7957,7952,5,"2.9"
4214102,"PRESIDENTE NEREU","SUL","SANTA CATARINA","224.7475913",2301,1185,1185,0,"2.6"
4214151,"PRINCESA","SUL","SANTA CATARINA","85.5975366",2964,1209,1209,0,"2.7"
4214201,"QUILOMBO","SUL","SANTA CATARINA","278.9833981",11022,4373,4367,6,"2.9"
4214300,"RANCHO QUEIMADO","SUL","SANTA CATARINA","286.4612665",3279,2444,2442,2,"2.6"
4214409,"RIO DAS ANTAS","SUL","SANTA CATARINA","314.9129084",6253,2847,2846,1,"2.8"
4214508,"RIO DO CAMPO","SUL","SANTA CATARINA","502.0946793",6452,2788,2787,1,"2.7"
4214607,"RIO DO OESTE","SUL","SANTA CATARINA","245.0568716",7747,3166,3163,3,"2.8"
4214706,"RIO DOS CEDROS","SUL","SANTA CATARINA","555.4729237",10865,5489,5483,6,"2.8"
4214805,"RIO DO SUL","SUL","SANTA CATARINA","260.8172984",72587,30065,30034,31,"2.6"
4214904,"RIO FORTUNA","SUL","SANTA CATARINA","302.3896294",4847,1909,1908,1,"3"
4215000,"RIO NEGRINHO","SUL","SANTA CATARINA","907.4197251",39261,15414,15399,15,"2.9"
4215059,"RIO RUFINO","SUL","SANTA CATARINA","282.5708533",2397,1318,1316,2,"2.7"
4215075,"RIQUEZA","SUL","SANTA CATARINA","191.0613462",4768,2103,2103,0,"2.6"
4215109,"RODEIO","SUL","SANTA CATARINA","129.0010182",12757,5284,5279,5,"2.7"
4215208,"ROMELÂNDIA","SUL","SANTA CATARINA","223.3329189",4823,2194,2194,0,"2.6"
4215307,"SALETE","SUL","SANTA CATARINA","177.8867187",7489,3223,3221,2,"2.7"
4215356,"SALTINHO","SUL","SANTA CATARINA","156.5682106",3632,1609,1609,0,"2.7"
4215406,"SALTO VELOSO","SUL","SANTA CATARINA","104.5313756",4390,1864,1864,0,"2.6"
4215455,"SANGÃO","SUL","SANTA CATARINA","82.9836527",12882,4471,4465,6,"3"
4215505,"SANTA CECÍLIA","SUL","SANTA CATARINA","1145.8448269",15546,6118,6109,9,"2.9"
4215554,"SANTA HELENA","SUL","SANTA CATARINA","81.0038545",2425,971,971,0,"2.7"
4215604,"SANTA ROSA DE LIMA","SUL","SANTA CATARINA","203.217657",2088,895,893,2,"2.8"
4215653,"SANTA ROSA DO SUL","SUL","SANTA CATARINA","150.2986326",9792,4337,4334,3,"2.7"
4215679,"SANTA TEREZINHA","SUL","SANTA CATARINA","715.5507916",8066,3453,3451,2,"2.7"
4215687,"SANTA TEREZINHA DO PROGRESSO","SUL","SANTA CATARINA","119.6530985",2576,1110,1110,0,"2.7"
4215695,"SANTIAGO DO SUL","SUL","SANTA CATARINA","73.3350923",1651,643,642,1,"2.9"
4215703,"SANTO AMARO DA IMPERATRIZ","SUL","SANTA CATARINA","344.2352124",27272,12342,12328,14,"2.7"
4215752,"SÃO BERNARDINO","SUL","SANTA CATARINA","149.8913579",2684,1097,1097,0,"2.7"
4215802,"SÃO BENTO DO SUL","SUL","SANTA CATARINA","495.7716496",83277,33603,33577,26,"2.8"
4215901,"SÃO BONIFÁCIO","SUL","SANTA CATARINA","461.4378943",2946,1673,1666,7,"2.6"
4216008,"SÃO CARLOS","SUL","SANTA CATARINA","162.1204532",10282,4576,4569,7,"2.7"
4216057,"SÃO CRISTÓVÃO DO SUL","SUL","SANTA CATARINA","345.9025259",6084,1878,1874,4,"2.9"
4216107,"SÃO DOMINGOS","SUL","SANTA CATARINA","367.5253992",9226,3937,3930,7,"2.7"
4216206,"SÃO FRANCISCO DO SUL","SUL","SANTA CATARINA","493.2663689",52674,38982,38934,48,"2.7"
4216255,"SÃO JOÃO DO OESTE","SUL","SANTA CATARINA","163.7469507",6295,2615,2611,4,"2.7"
4216305,"SÃO JOÃO BATISTA","SUL","SANTA CATARINA","200.764922",32687,13444,13433,11,"2.8"
4216354,"SÃO JOÃO DO ITAPERIÚ","SUL","SANTA CATARINA","151.8845527",4463,1822,1821,1,"3"
4216404,"SÃO JOÃO DO SUL","SUL","SANTA CATARINA","184.3746618",8668,4210,4208,2,"2.6"
4216503,"SÃO JOAQUIM","SUL","SANTA CATARINA","1888.6343842",25939,12097,12054,43,"2.7"
4216602,"SÃO JOSÉ","SUL","SANTA CATARINA","150.4993149",270299,120425,120368,57,"2.6"
4216701,"SÃO JOSÉ DO CEDRO","SUL","SANTA CATARINA","280.7597475",14167,5927,5920,7,"2.6"
4216800,"SÃO JOSÉ DO CERRITO","SUL","SANTA CATARINA","948.714458",8708,4663,4663,0,"2.6"
4216909,"SÃO LOURENÇO DO OESTE","SUL","SANTA CATARINA","356.1926642",24791,9974,9965,9,"2.7"
4217006,"SÃO LUDGERO","SUL","SANTA CATARINA","106.7651153",13509,5268,5268,0,"2.9"
4217105,"SÃO MARTINHO","SUL","SANTA CATARINA","224.5657014",3405,1447,1446,1,"2.9"
4217154,"SÃO MIGUEL DA BOA VISTA","SUL","SANTA CATARINA","72.7546903",1781,756,756,0,"2.7"
4217204,"SÃO MIGUEL DO OESTE","SUL","SANTA CATARINA","234.2024145",44330,18908,18877,31,"2.5"
4217253,"SÃO PEDRO DE ALCÂNTARA","SUL","SANTA CATARINA","139.1963187",5776,2577,2574,3,"2.6"
4217303,"SAUDADES","SUL","SANTA CATARINA","205.7805559",10265,3885,3885,0,"2.9"
4217402,"SCHROEDER","SUL","SANTA CATARINA","165.2371535",20061,7348,7345,3,"2.9"
4217501,"SEARA","SUL","SANTA CATARINA","309.6274578",18620,7524,7521,3,"2.8"
4217550,"SERRA ALTA","SUL","SANTA CATARINA","90.5637924",3303,1351,1351,0,"2.7"
4217600,"SIDERÓPOLIS","SUL","SANTA CATARINA","262.0026676",13714,6003,5995,8,"2.8"
4217709,"SOMBRIO","SUL","SANTA CATARINA","143.4573561",29991,12348,12345,3,"2.7"
4217758,"SUL BRASIL","SUL","SANTA CATARINA","113.1254356",2832,1084,1084,0,"2.8"
4217808,"TAIÓ","SUL","SANTA CATARINA","693.8465648",18310,7929,7921,8,"2.7"
4217907,"TANGARÁ","SUL","SANTA CATARINA","390.0443324",8143,3631,3629,2,"2.7"
4217956,"TIGRINHOS","SUL","SANTA CATARINA","56.9621668",2329,968,968,0,"2.7"
4218004,"TIJUCAS","SUL","SANTA CATARINA","279.1586841",51592,21174,21159,15,"2.8"
4218103,"TIMBÉ DO SUL","SUL","SANTA CATARINA","328.5068777",5386,2544,2542,2,"2.7"
4218202,"TIMBÓ","SUL","SANTA CATARINA","128.3127953",46099,18380,18370,10,"2.8"
4218251,"TIMBÓ GRANDE","SUL","SANTA CATARINA","596.3436948",7342,3058,3053,5,"2.9"
4218301,"TRÊS BARRAS","SUL","SANTA CATARINA","436.4964557",19746,7549,7542,7,"3"
4218350,"TREVISO","SUL","SANTA CATARINA","156.6100643",3782,1769,1767,2,"2.8"
4218400,"TREZE DE MAIO","SUL","SANTA CATARINA","159.8330629",7362,3082,3081,1,"2.8"
4218509,"TREZE TÍLIAS","SUL","SANTA CATARINA","185.9372186",8787,3674,3655,19,"2.7"
4218608,"TROMBUDO CENTRAL","SUL","SANTA CATARINA","109.6481566",7274,3090,3085,5,"2.7"
4218707,"TUBARÃO","SUL","SANTA CATARINA","301.4845576",110088,48567,48534,33,"2.6"
4218756,"TUNÁPOLIS","SUL","SANTA CATARINA","132.93892",4916,1974,1973,1,"2.8"
4218806,"TURVO","SUL","SANTA CATARINA","235.10377",13043,5442,5414,28,"2.7"
4218855,"UNIÃO DO OESTE","SUL","SANTA CATARINA","92.8571743",2774,1156,1156,0,"2.7"
4218905,"URUBICI","SUL","SANTA CATARINA","1021.3713738",10834,5727,5627,100,"2.7"
4218954,"URUPEMA","SUL","SANTA CATARINA","350.4723949",2656,1406,1386,20,"2.8"
4219002,"URUSSANGA","SUL","SANTA CATARINA","254.9537581",20919,9080,9073,7,"2.7"
4219101,"VARGEÃO","SUL","SANTA CATARINA","166.6850086",3634,1425,1424,1,"2.8"
4219150,"VARGEM","SUL","SANTA CATARINA","350.6062424",2627,1306,1305,1,"2.6"
4219176,"VARGEM BONITA","SUL","SANTA CATARINA","299.8067503",4576,1930,1927,3,"2.8"
4219200,"VIDAL RAMOS","SUL","SANTA CATARINA","346.9315333",6189,3004,2999,5,"2.6"
4219309,"VIDEIRA","SUL","SANTA CATARINA","384.1264956",55466,23365,23352,13,"2.7"
4219358,"VITOR MEIRELES","SUL","SANTA CATARINA","370.4141179",5370,2263,2261,2,"2.8"
4219408,"WITMARSUM","SUL","SANTA CATARINA","153.775611",4255,1764,1762,2,"2.8"
4219507,"XANXERÊ","SUL","SANTA CATARINA","377.4262152",51607,20714,20698,16,"2.7"
4219606,"XAVANTINA","SUL","SANTA CATARINA","218.0323228",3653,1449,1449,0,"2.9"
4219705,"XAXIM","SUL","SANTA CATARINA","293.6274964",31918,12391,12391,0,"2.7"
4219853,"ZORTÉA","SUL","SANTA CATARINA","190.1786214",3930,1770,1770,0,"2.7"
4220000,"BALNEÁRIO RINCÃO","SUL","SANTA CATARINA","63.4203771",15981,15712,15700,12,"2.7"
4300034,"ACEGUÁ","SUL","RIO GRANDE DO SUL","1551.3390611",4170,2125,2123,2,"2.6"
4300059,"ÁGUA SANTA","SUL","RIO GRANDE DO SUL","291.5033209",3912,1596,1596,0,"2.8"
4300109,"AGUDO","SUL","RIO GRANDE DO SUL","534.624148",16041,7373,7368,5,"2.6"
4300208,"AJURICABA","SUL","RIO GRANDE DO SUL","322.6741953",6720,2998,2989,9,"2.6"
4300307,"ALECRIM","SUL","RIO GRANDE DO SUL","316.3937376",6123,3291,3290,1,"2.4"
4300406,"ALEGRETE","SUL","RIO GRANDE DO SUL","7800.4277955",72409,34657,34624,33,"2.5"
4300455,"ALEGRIA","SUL","RIO GRANDE DO SUL","172.7941662",3651,1865,1865,0,"2.5"
4300471,"ALMIRANTE TAMANDARÉ DO SUL","SUL","RIO GRANDE DO SUL","265.0418488",1969,979,978,1,"2.5"
4300505,"ALPESTRE","SUL","RIO GRANDE DO SUL","325.9787317",7117,3455,3453,2,"2.5"
4300554,"ALTO ALEGRE","SUL","RIO GRANDE DO SUL","115.334931",1800,810,810,0,"2.6"
4300570,"ALTO FELIZ","SUL","RIO GRANDE DO SUL","78.1747513",3072,1626,1626,0,"2.5"
4300604,"ALVORADA","SUL","RIO GRANDE DO SUL","71.7005078",187315,79779,79737,42,"2.7"
4300638,"AMARAL FERRADOR","SUL","RIO GRANDE DO SUL","505.9830586",5310,2883,2882,1,"2.6"
4300646,"AMETISTA DO SUL","SUL","RIO GRANDE DO SUL","93.7044297",7650,3469,3379,90,"2.6"
4300661,"ANDRÉ DA ROCHA","SUL","RIO GRANDE DO SUL","331.208193",1135,644,640,4,"2.6"
4300703,"ANTA GORDA","SUL","RIO GRANDE DO SUL","242.0995828",5957,2759,2758,1,"2.7"
4300802,"ANTÔNIO PRADO","SUL","RIO GRANDE DO SUL","347.5412067",13045,6179,6177,2,"2.6"
4300851,"ARAMBARÉ","SUL","RIO GRANDE DO SUL","518.1927499",4112,4833,4816,17,"2.4"
4300877,"ARARICÁ","SUL","RIO GRANDE DO SUL","35.3908947",8525,3578,3577,1,"2.7"
4300901,"ARATIBA","SUL","RIO GRANDE DO SUL","342.278563",6483,3434,3434,0,"2.5"
4301008,"ARROIO DO MEIO","SUL","RIO GRANDE DO SUL","157.0875182",21958,9791,9778,13,"2.6"
4301057,"ARROIO DO SAL","SUL","RIO GRANDE DO SUL","119.1603508",11057,18880,18797,83,"2.5"
4301073,"ARROIO DO PADRE","SUL","RIO GRANDE DO SUL","124.6927136",2599,991,991,0,"3.2"
4301107,"ARROIO DOS RATOS","SUL","RIO GRANDE DO SUL","425.7911866",14601,7004,6998,6,"2.5"
4301206,"ARROIO DO TIGRE","SUL","RIO GRANDE DO SUL","315.131665",12058,5049,5044,5,"2.7"
4301305,"ARROIO GRANDE","SUL","RIO GRANDE DO SUL","2508.5574242",17558,9516,9497,19,"2.4"
4301404,"ARVOREZINHA","SUL","RIO GRANDE DO SUL","269.3102574",10322,4584,4582,2,"2.6"
4301503,"AUGUSTO PESTANA","SUL","RIO GRANDE DO SUL","348.2313043",7149,3259,3256,3,"2.5"
4301552,"ÁUREA","SUL","RIO GRANDE DO SUL","156.727179",3396,1636,1634,2,"2.6"
4301602,"BAGÉ","SUL","RIO GRANDE DO SUL","4090.3598715",117938,53716,53629,87,"2.6"
4301636,"BALNEÁRIO PINHAL","SUL","RIO GRANDE DO SUL","102.387027",14955,19322,19263,59,"2.4"
4301651,"BARÃO","SUL","RIO GRANDE DO SUL","124.7571227",6461,3003,3001,2,"2.7"
4301701,"BARÃO DE COTEGIPE","SUL","RIO GRANDE DO SUL","260.5046827",7144,3217,3213,4,"2.6"
4301750,"BARÃO DO TRIUNFO","SUL","RIO GRANDE DO SUL","436.1007073",5889,3451,3449,2,"2.4"
4301800,"BARRACÃO","SUL","RIO GRANDE DO SUL","515.4690776",4831,2458,2453,5,"2.5"
4301859,"BARRA DO GUARITA","SUL","RIO GRANDE DO SUL","62.8014336",3161,1377,1377,0,"2.7"
4301875,"BARRA DO QUARAÍ","SUL","RIO GRANDE DO SUL","1055.9365918",4241,1729,1727,2,"2.9"
4301909,"BARRA DO RIBEIRO","SUL","RIO GRANDE DO SUL","729.3157833",12225,6512,6506,6,"2.5"
4301925,"BARRA DO RIO AZUL","SUL","RIO GRANDE DO SUL","146.9946746",1696,722,722,0,"2.7"
4301958,"BARRA FUNDA","SUL","RIO GRANDE DO SUL","60.4366129",2498,1030,1027,3,"2.8"
4302006,"BARROS CASSAL","SUL","RIO GRANDE DO SUL","647.9937248",9296,4827,4824,3,"2.5"
4302055,"BENJAMIN CONSTANT DO SUL","SUL","RIO GRANDE DO SUL","132.3507469",2082,846,846,0,"2.9"
4302105,"BENTO GONÇALVES","SUL","RIO GRANDE DO SUL","272.2874352",123151,55648,55535,113,"2.5"
4302154,"BOA VISTA DAS MISSÕES","SUL","RIO GRANDE DO SUL","196.0636595",1933,908,907,1,"2.5"
4302204,"BOA VISTA DO BURICÁ","SUL","RIO GRANDE DO SUL","109.5410981",6966,3030,3024,6,"2.5"
4302220,"BOA VISTA DO CADEADO","SUL","RIO GRANDE DO SUL","701.2206209",2229,1082,1081,1,"2.6"
4302238,"BOA VISTA DO INCRA","SUL","RIO GRANDE DO SUL","504.1135127",2271,1014,1011,3,"2.7"
4302253,"BOA VISTA DO SUL","SUL","RIO GRANDE DO SUL","94.3986436",2779,1292,1291,1,"2.6"
4302303,"BOM JESUS","SUL","RIO GRANDE DO SUL","2622.8366863",11202,5436,5426,10,"2.7"
4302352,"BOM PRINCÍPIO","SUL","RIO GRANDE DO SUL","88.6601294",13142,5831,5823,8,"2.6"
4302378,"BOM PROGRESSO","SUL","RIO GRANDE DO SUL","89.2064207",2096,970,969,1,"2.6"
4302402,"BOM RETIRO DO SUL","SUL","RIO GRANDE DO SUL","102.5395949",12294,5861,5853,8,"2.5"
4302451,"BOQUEIRÃO DO LEÃO","SUL","RIO GRANDE DO SUL","265.9517733",6247,3112,3110,2,"2.5"
4302501,"BOSSOROCA","SUL","RIO GRANDE DO SUL","1610.0564819",5890,3350,3347,3,"2.5"
4302584,"BOZANO","SUL","RIO GRANDE DO SUL","200.4970658",2151,993,991,2,"2.7"
4302600,"BRAGA","SUL","RIO GRANDE DO SUL","132.0442066",3268,1415,1414,1,"2.6"
4302659,"BROCHIER","SUL","RIO GRANDE DO SUL","105.3527157",4966,2535,2533,2,"2.4"
4302709,"BUTIÁ","SUL","RIO GRANDE DO SUL","752.1866209",19084,9091,9082,9,"2.6"
4302808,"CAÇAPAVA DO SUL","SUL","RIO GRANDE DO SUL","3048.1466099",32515,18383,18346,37,"2.4"
4302907,"CACEQUI","SUL","RIO GRANDE DO SUL","2373.5068091",11157,5312,5305,7,"2.6"
4303004,"CACHOEIRA DO SUL","SUL","RIO GRANDE DO SUL","3736.0643114",80070,39091,39026,65,"2.5"
4303103,"CACHOEIRINHA","SUL","RIO GRANDE DO SUL","43.7775313",136258,60602,60580,22,"2.6"
4303202,"CACIQUE DOBLE","SUL","RIO GRANDE DO SUL","204.0547025",4603,1904,1903,1,"2.8"
4303301,"CAIBATÉ","SUL","RIO GRANDE DO SUL","261.3028064",4704,2331,2330,1,"2.5"
4303400,"CAIÇARA","SUL","RIO GRANDE DO SUL","189.1603702",4836,2214,2210,4,"2.6"
4303509,"CAMAQUÃ","SUL","RIO GRANDE DO SUL","1680.16769",62200,28366,28344,22,"2.6"
4303558,"CAMARGO","SUL","RIO GRANDE DO SUL","138.0685809",2981,1306,1306,0,"2.6"
4303608,"CAMBARÁ DO SUL","SUL","RIO GRANDE DO SUL","1181.8113682",6361,3343,3270,73,"2.6"
4303673,"CAMPESTRE DA SERRA","SUL","RIO GRANDE DO SUL","538.4873722",3242,1819,1818,1,"2.5"
4303707,"CAMPINA DAS MISSÕES","SUL","RIO GRANDE DO SUL","224.8013925",5882,2667,2664,3,"2.6"
4303806,"CAMPINAS DO SUL","SUL","RIO GRANDE DO SUL","276.1621489",5284,2596,2592,4,"2.6"
4303905,"CAMPO BOM","SUL","RIO GRANDE DO SUL","60.5788565",62886,27222,27212,10,"2.6"
4304002,"CAMPO NOVO","SUL","RIO GRANDE DO SUL","220.7188093",4975,2210,2210,0,"2.6"
4304101,"CAMPOS BORGES","SUL","RIO GRANDE DO SUL","226.2020152",3613,1845,1844,1,"2.5"
4304200,"CANDELÁRIA","SUL","RIO GRANDE DO SUL","944.7351171",28906,14095,14078,17,"2.5"
4304309,"CÂNDIDO GODÓI","SUL","RIO GRANDE DO SUL","247.0471878",6294,2747,2746,1,"2.6"
4304358,"CANDIOTA","SUL","RIO GRANDE DO SUL","933.6277424",10710,4861,4826,35,"2.6"
4304408,"CANELA","SUL","RIO GRANDE DO SUL","253.0024251",48946,24667,24609,58,"2.7"
4304507,"CANGUÇU","SUL","RIO GRANDE DO SUL","3526.3903792",49680,24699,24685,14,"2.6"
4304606,"CANOAS","SUL","RIO GRANDE DO SUL","130.7885626",347657,155478,155375,103,"2.6"
4304614,"CANUDOS DO VALE","SUL","RIO GRANDE DO SUL","82.9080018",1656,804,804,0,"2.6"
4304622,"CAPÃO BONITO DO SUL","SUL","RIO GRANDE DO SUL","526.8495951",1733,986,986,0,"2.5"
4304630,"CAPÃO DA CANOA","SUL","RIO GRANDE DO SUL","98.3825273",63594,59251,59167,84,"2.7"
4304655,"CAPÃO DO CIPÓ","SUL","RIO GRANDE DO SUL","1007.7964203",3119,1409,1408,1,"2.7"
4304663,"CAPÃO DO LEÃO","SUL","RIO GRANDE DO SUL","783.1963794",26487,12183,12176,7,"2.6"
4304671,"CAPIVARI DO SUL","SUL","RIO GRANDE DO SUL","412.8893918",3991,1958,1957,1,"2.7"
4304689,"CAPELA DE SANTANA","SUL","RIO GRANDE DO SUL","182.7564786",11159,5361,5359,2,"2.6"
4304697,"CAPITÃO","SUL","RIO GRANDE DO SUL","73.967091",2921,1213,1213,0,"2.8"
4304705,"CARAZINHO","SUL","RIO GRANDE DO SUL","666.6937873",61804,27015,26992,23,"2.5"
4304713,"CARAÁ","SUL","RIO GRANDE DO SUL","294.6063546",7394,4856,4850,6,"2.5"
4304804,"CARLOS BARBOSA","SUL","RIO GRANDE DO SUL","230.0614384",30420,13745,13734,11,"2.6"
4304853,"CARLOS GOMES","SUL","RIO GRANDE DO SUL","83.1546307",1368,638,637,1,"2.7"
4304903,"CASCA","SUL","RIO GRANDE DO SUL","272.0408731",9465,4244,4238,6,"2.6"
4304952,"CASEIROS","SUL","RIO GRANDE DO SUL","235.8633105",3000,1325,1324,1,"2.7"
4305009,"CATUÍPE","SUL","RIO GRANDE DO SUL","583.18423",8674,3960,3959,1,"2.6"
4305108,"CAXIAS DO SUL","SUL","RIO GRANDE DO SUL","1652.319549",463501,220438,220286,152,"2.5"
4305116,"CENTENÁRIO","SUL","RIO GRANDE DO SUL","134.2300237",2721,1244,1244,0,"2.6"
4305124,"CERRITO","SUL","RIO GRANDE DO SUL","451.6985151",5808,3315,3315,0,"2.4"
4305132,"CERRO BRANCO","SUL","RIO GRANDE DO SUL","158.0245297",3802,2066,2065,1,"2.4"
4305157,"CERRO GRANDE","SUL","RIO GRANDE DO SUL","73.4376826",2379,1025,1025,0,"2.6"
4305173,"CERRO GRANDE DO SUL","SUL","RIO GRANDE DO SUL","324.9076889",9178,4670,4666,4,"2.5"
4305207,"CERRO LARGO","SUL","RIO GRANDE DO SUL","176.6435459",13705,6248,6238,10,"2.5"
4305306,"CHAPADA","SUL","RIO GRANDE DO SUL","684.2465085",9540,4395,4391,4,"2.5"
4305355,"CHARQUEADAS","SUL","RIO GRANDE DO SUL","217.3617795",35012,13957,13934,23,"2.6"
4305371,"CHARRUA","SUL","RIO GRANDE DO SUL","198.7478596",2768,1079,1079,0,"2.9"
4305405,"CHIAPETTA","SUL","RIO GRANDE DO SUL","397.1793244",3913,1843,1842,1,"2.6"
4305439,"CHUÍ","SUL","RIO GRANDE DO SUL","202.3868632",6262,3008,3001,7,"2.6"
4305447,"CHUVISCA","SUL","RIO GRANDE DO SUL","220.4713725",4597,2116,2116,0,"2.8"
4305454,"CIDREIRA","SUL","RIO GRANDE DO SUL","243.4193123",17071,23877,23833,44,"2.5"
4305504,"CIRÍACO","SUL","RIO GRANDE DO SUL","274.3495885",4149,2021,2021,0,"2.5"
4305587,"COLINAS","SUL","RIO GRANDE DO SUL","60.7319533",2423,1137,1136,1,"2.6"
4305603,"COLORADO","SUL","RIO GRANDE DO SUL","286.2946904",3258,1487,1487,0,"2.5"
4305702,"CONDOR","SUL","RIO GRANDE DO SUL","463.5678035",6406,2793,2793,0,"2.7"
4305801,"CONSTANTINA","SUL","RIO GRANDE DO SUL","203.6135235",10385,4223,4221,2,"2.7"
4305835,"COQUEIRO BAIXO","SUL","RIO GRANDE DO SUL","112.6383186",1290,688,688,0,"2.6"
4305850,"COQUEIROS DO SUL","SUL","RIO GRANDE DO SUL","277.1470074",2211,1108,1108,0,"2.5"
4305871,"CORONEL BARROS","SUL","RIO GRANDE DO SUL","163.6835926",2822,1358,1357,1,"2.6"
4305900,"CORONEL BICACO","SUL","RIO GRANDE DO SUL","492.3031187",6144,2877,2876,1,"2.6"
4305934,"CORONEL PILAR","SUL","RIO GRANDE DO SUL","105.6684031",1607,798,796,2,"2.8"
4305959,"COTIPORÃ","SUL","RIO GRANDE DO SUL","173.2074067",3846,1854,1843,11,"2.7"
4305975,"COXILHA","SUL","RIO GRANDE DO SUL","422.1012477",2667,1308,1306,2,"2.6"
4306007,"CRISSIUMAL","SUL","RIO GRANDE DO SUL","362.1940224",12886,6127,6118,9,"2.4"
4306056,"CRISTAL","SUL","RIO GRANDE DO SUL","682.0000128",7299,3540,3536,4,"2.6"
4306072,"CRISTAL DO SUL","SUL","RIO GRANDE DO SUL","97.0771745",2692,1263,1256,7,"2.5"
4306106,"CRUZ ALTA","SUL","RIO GRANDE DO SUL","1360.5476944",58913,27132,27102,30,"2.6"
4306130,"CRUZALTENSE","SUL","RIO GRANDE DO SUL","166.8826844",1635,793,793,0,"2.7"
4306205,"CRUZEIRO DO SUL","SUL","RIO GRANDE DO SUL","155.0583032",11600,5723,5720,3,"2.5"
4306304,"DAVID CANABARRO","SUL","RIO GRANDE DO SUL","174.734242",4321,1966,1965,1,"2.6"
4306320,"DERRUBADAS","SUL","RIO GRANDE DO SUL","360.8505969",2751,1216,1216,0,"2.6"
4306353,"DEZESSEIS DE NOVEMBRO","SUL","RIO GRANDE DO SUL","217.3628777",2507,1431,1431,0,"2.5"
4306379,"DILERMANDO DE AGUIAR","SUL","RIO GRANDE DO SUL","600.5180728",2806,1711,1711,0,"2.4"
4306403,"DOIS IRMÃOS","SUL","RIO GRANDE DO SUL","66.1139765",30709,13541,13532,9,"2.6"
4306429,"DOIS IRMÃOS DAS MISSÕES","SUL","RIO GRANDE DO SUL","226.0722733",2090,956,954,2,"2.6"
4306452,"DOIS LAJEADOS","SUL","RIO GRANDE DO SUL","133.5347898",3097,1489,1487,2,"2.7"
4306502,"DOM FELICIANO","SUL","RIO GRANDE DO SUL","1355.1949642",13051,6745,6743,2,"2.6"
4306551,"DOM PEDRO DE ALCÂNTARA","SUL","RIO GRANDE DO SUL","78.2160431",2562,1453,1453,0,"2.4"
4306601,"DOM PEDRITO","SUL","RIO GRANDE DO SUL","5194.0513763",36981,17110,17038,72,"2.6"
4306700,"DONA FRANCISCA","SUL","RIO GRANDE DO SUL","114.1490178",3079,1456,1456,0,"2.5"
4306734,"DOUTOR MAURÍCIO CARDOSO","SUL","RIO GRANDE DO SUL","255.7314802",4470,2542,2541,1,"2.4"
4306759,"DOUTOR RICARDO","SUL","RIO GRANDE DO SUL","107.9603984",1888,927,927,0,"2.7"
4306767,"ELDORADO DO SUL","SUL","RIO GRANDE DO SUL","509.6144917",39559,18785,18772,13,"2.7"
4306809,"ENCANTADO","SUL","RIO GRANDE DO SUL","140.0062989",22962,10323,10308,15,"2.5"
4306908,"ENCRUZILHADA DO SUL","SUL","RIO GRANDE DO SUL","3347.8612306",23819,12905,12898,7,"2.5"
4306924,"ENGENHO VELHO","SUL","RIO GRANDE DO SUL","71.1910715",1296,498,498,0,"2.9"
4306932,"ENTRE-IJUÍS","SUL","RIO GRANDE DO SUL","552.9860995",9158,4789,4787,2,"2.5"
4306957,"ENTRE RIOS DO SUL","SUL","RIO GRANDE DO SUL","119.9123405",2685,1316,1314,2,"2.5"
4306973,"EREBANGO","SUL","RIO GRANDE DO SUL","152.7928809",3054,1242,1241,1,"2.8"
4307005,"ERECHIM","SUL","RIO GRANDE DO SUL","429.1642772",105705,49073,49038,35,"2.5"
4307054,"ERNESTINA","SUL","RIO GRANDE DO SUL","238.5584513",3034,2138,2131,7,"2.4"
4307104,"HERVAL","SUL","RIO GRANDE DO SUL","1759.7173373",6191,3871,3864,7,"2.3"
4307203,"ERVAL GRANDE","SUL","RIO GRANDE DO SUL","285.6772664",4930,2559,2557,2,"2.5"
4307302,"ERVAL SECO","SUL","RIO GRANDE DO SUL","357.1808403",6787,3141,3141,0,"2.6"
4307401,"ESMERALDA","SUL","RIO GRANDE DO SUL","829.5871072",3195,1866,1865,1,"2.6"
4307450,"ESPERANÇA DO SUL","SUL","RIO GRANDE DO SUL","148.9093002",3226,1567,1567,0,"2.5"
4307500,"ESPUMOSO","SUL","RIO GRANDE DO SUL","783.6419471",15173,6492,6484,8,"2.6"
4307559,"ESTAÇÃO","SUL","RIO GRANDE DO SUL","99.7573455",5582,2422,2422,0,"2.6"
4307609,"ESTÂNCIA VELHA","SUL","RIO GRANDE DO SUL","51.7790563",47924,20138,20127,11,"2.7"
4307708,"ESTEIO","SUL","RIO GRANDE DO SUL","27.6763486",76137,33170,33145,25,"2.6"
4307807,"ESTRELA","SUL","RIO GRANDE DO SUL","185.0262325",32183,14528,14517,11,"2.6"
4307815,"ESTRELA VELHA","SUL","RIO GRANDE DO SUL","281.6125405",3070,1367,1365,2,"2.6"
4307831,"EUGÊNIO DE CASTRO","SUL","RIO GRANDE DO SUL","418.0687624",2633,1403,1401,2,"2.3"
4307864,"FAGUNDES VARELA","SUL","RIO GRANDE DO SUL","134.2951454",2566,1129,1129,0,"2.9"
4307906,"FARROUPILHA","SUL","RIO GRANDE DO SUL","361.3412387",70286,31754,31725,29,"2.6"
4308003,"FAXINAL DO SOTURNO","SUL","RIO GRANDE DO SUL","169.5142014",6702,2968,2965,3,"2.6"
4308052,"FAXINALZINHO","SUL","RIO GRANDE DO SUL","143.3207513",2520,1248,1248,0,"2.5"
4308078,"FAZENDA VILANOVA","SUL","RIO GRANDE DO SUL","84.7940159",4291,2078,2077,1,"2.6"
4308102,"FELIZ","SUL","RIO GRANDE DO SUL","94.8317772",13764,6272,6263,9,"2.5"
4308201,"FLORES DA CUNHA","SUL","RIO GRANDE DO SUL","276.241218",30892,13933,13928,5,"2.6"
4308250,"FLORIANO PEIXOTO","SUL","RIO GRANDE DO SUL","168.5214119",1668,900,900,0,"2.4"
4308300,"FONTOURA XAVIER","SUL","RIO GRANDE DO SUL","583.2389225",9550,4749,4744,5,"2.6"
4308409,"FORMIGUEIRO","SUL","RIO GRANDE DO SUL","578.8748721",6413,3316,3308,8,"2.5"
4308433,"FORQUETINHA","SUL","RIO GRANDE DO SUL","93.2746589",2393,1360,1359,1,"2.5"
4308458,"FORTALEZA DOS VALOS","SUL","RIO GRANDE DO SUL","650.512404",4477,2191,2189,2,"2.6"
4308508,"FREDERICO WESTPHALEN","SUL","RIO GRANDE DO SUL","265.1810882",32627,15243,15221,22,"2.5"
4308607,"GARIBALDI","SUL","RIO GRANDE DO SUL","168.4917999",34335,15423,15408,15,"2.6"
4308656,"GARRUCHOS","SUL","RIO GRANDE DO SUL","803.7369778",2688,1536,1534,2,"2.5"
4308706,"GAURAMA","SUL","RIO GRANDE DO SUL","204.4283462",5665,2695,2691,4,"2.5"
4308805,"GENERAL CÂMARA","SUL","RIO GRANDE DO SUL","510.0096193",7612,4488,4484,4,"2.4"
4308854,"GENTIL","SUL","RIO GRANDE DO SUL","184.7153102",1744,763,763,0,"2.7"
4308904,"GETÚLIO VARGAS","SUL","RIO GRANDE DO SUL","287.4660721",16602,7694,7689,5,"2.5"
4309001,"GIRUÁ","SUL","RIO GRANDE DO SUL","857.0588321",16013,7033,7027,6,"2.6"
4309050,"GLORINHA","SUL","RIO GRANDE DO SUL","323.9553825",7658,4656,4647,9,"2.6"
4309100,"GRAMADO","SUL","RIO GRANDE DO SUL","239.3409471",40134,24248,24056,192,"2.6"
4309126,"GRAMADO DOS LOUREIROS","SUL","RIO GRANDE DO SUL","131.3955815",2014,928,928,0,"2.8"
4309159,"GRAMADO XAVIER","SUL","RIO GRANDE DO SUL","217.5155033",3304,1578,1577,1,"2.7"
4309209,"GRAVATAÍ","SUL","RIO GRANDE DO SUL","468.2878987",265074,119363,119303,60,"2.6"
4309258,"GUABIJU","SUL","RIO GRANDE DO SUL","146.9252435",1417,653,653,0,"2.5"
4309308,"GUAÍBA","SUL","RIO GRANDE DO SUL","376.166072",92924,41073,41057,16,"2.6"
4309407,"GUAPORÉ","SUL","RIO GRANDE DO SUL","297.5452333",25268,11124,11114,10,"2.6"
4309506,"GUARANI DAS MISSÕES","SUL","RIO GRANDE DO SUL","290.6998284",7415,3272,3266,6,"2.6"
4309555,"HARMONIA","SUL","RIO GRANDE DO SUL","48.5570122",5378,2344,2343,1,"2.7"
4309571,"HERVEIRAS","SUL","RIO GRANDE DO SUL","118.2608642",2565,1237,1233,4,"2.6"
4309605,"HORIZONTINA","SUL","RIO GRANDE DO SUL","229.6939651",18851,8413,8405,8,"2.5"
4309654,"HULHA NEGRA","SUL","RIO GRANDE DO SUL","822.6076757",5976,2974,2973,1,"2.7"
4309704,"HUMAITÁ","SUL","RIO GRANDE DO SUL","135.0104858",4681,2175,2172,3,"2.5"
4309753,"IBARAMA","SUL","RIO GRANDE DO SUL","195.4263521",3732,1717,1717,0,"2.6"
4309803,"IBIAÇÁ","SUL","RIO GRANDE DO SUL","348.7783873",4527,2107,2101,6,"2.5"
4309902,"IBIRAIARAS","SUL","RIO GRANDE DO SUL","292.1595617",6776,2974,2974,0,"2.7"
4309951,"IBIRAPUITÃ","SUL","RIO GRANDE DO SUL","307.1637754",3723,1888,1887,1,"2.5"
4310009,"IBIRUBÁ","SUL","RIO GRANDE DO SUL","607.1850659",21583,9228,9221,7,"2.6"
4310108,"IGREJINHA","SUL","RIO GRANDE DO SUL","138.3026413",32808,15137,15129,8,"2.6"
4310207,"IJUÍ","SUL","RIO GRANDE DO SUL","688.9821781",84780,37185,37149,36,"2.6"
4310306,"ILÓPOLIS","SUL","RIO GRANDE DO SUL","123.6020031",4157,1791,1789,2,"2.7"
4310330,"IMBÉ","SUL","RIO GRANDE DO SUL","39.765627",26824,32449,32336,113,"2.6"
4310363,"IMIGRANTE","SUL","RIO GRANDE DO SUL","71.7163762",3080,1404,1402,2,"2.6"
4310405,"INDEPENDÊNCIA","SUL","RIO GRANDE DO SUL","358.2835002",6427,2943,2943,0,"2.6"
4310413,"INHACORÁ","SUL","RIO GRANDE DO SUL","113.7489809",2014,944,944,0,"2.6"
4310439,"IPÊ","SUL","RIO GRANDE DO SUL","599.0319587",5399,3084,3082,2,"2.5"
4310462,"IPIRANGA DO SUL","SUL","RIO GRANDE DO SUL","158.7098826",1720,783,783,0,"2.5"
4310504,"IRAÍ","SUL","RIO GRANDE DO SUL","181.5792479",7482,3527,3518,9,"2.6"
4310538,"ITAARA","SUL","RIO GRANDE DO SUL","172.8010106",5572,3383,3372,11,"2.6"
4310553,"ITACURUBI","SUL","RIO GRANDE DO SUL","1120.8736112",2995,1690,1681,9,"2.6"
4310579,"ITAPUCA","SUL","RIO GRANDE DO SUL","184.6732295",1937,901,901,0,"2.7"
4310603,"ITAQUI","SUL","RIO GRANDE DO SUL","3406.6059289",35768,14767,14756,11,"2.8"
4310652,"ITATI","SUL","RIO GRANDE DO SUL","205.059671",2638,1634,1634,0,"2.5"
4310702,"ITATIBA DO SUL","SUL","RIO GRANDE DO SUL","212.6685119",3208,1635,1635,0,"2.5"
4310751,"IVORÁ","SUL","RIO GRANDE DO SUL","122.929676",1929,916,910,6,"2.6"
4310801,"IVOTI","SUL","RIO GRANDE DO SUL","63.091921",22983,9777,9766,11,"2.7"
4310850,"JABOTICABA","SUL","RIO GRANDE DO SUL","127.5891303",3779,1675,1671,4,"2.5"
4310876,"JACUIZINHO","SUL","RIO GRANDE DO SUL","339.3990535",2040,1085,1085,0,"2.6"
4310900,"JACUTINGA","SUL","RIO GRANDE DO SUL","178.0091849",3338,1531,1527,4,"2.5"
4311007,"JAGUARÃO","SUL","RIO GRANDE DO SUL","2051.8452283",26603,13251,13225,26,"2.4"
4311106,"JAGUARI","SUL","RIO GRANDE DO SUL","675.3143789",10579,5139,5129,10,"2.4"
4311122,"JAQUIRANA","SUL","RIO GRANDE DO SUL","908.8785162",3690,2289,2288,1,"2.6"
4311130,"JARI","SUL","RIO GRANDE DO SUL","853.0800515",3349,1705,1704,1,"2.5"
4311155,"JÓIA","SUL","RIO GRANDE DO SUL","1238.917839",7184,3406,3403,3,"2.6"
4311205,"JÚLIO DE CASTILHOS","SUL","RIO GRANDE DO SUL","1929.5442214",18226,8519,8497,22,"2.6"
4311239,"LAGOA BONITA DO SUL","SUL","RIO GRANDE DO SUL","109.7579003",2251,1058,1058,0,"2.6"
4311254,"LAGOÃO","SUL","RIO GRANDE DO SUL","387.4856827",5341,2615,2609,6,"2.6"
4311270,"LAGOA DOS TRÊS CANTOS","SUL","RIO GRANDE DO SUL","138.6015262",1738,779,778,1,"2.6"
4311304,"LAGOA VERMELHA","SUL","RIO GRANDE DO SUL","1260.2271191",27659,12860,12851,9,"2.5"
4311403,"LAJEADO","SUL","RIO GRANDE DO SUL","91.2309011",93646,44610,44566,44,"2.4"
4311429,"LAJEADO DO BUGRE","SUL","RIO GRANDE DO SUL","67.9471386",2601,1095,1095,0,"2.6"
4311502,"LAVRAS DO SUL","SUL","RIO GRANDE DO SUL","2600.9694652",7157,4335,4309,26,"2.4"
4311601,"LIBERATO SALZANO","SUL","RIO GRANDE DO SUL","245.6268871",4781,2201,2200,1,"2.6"
4311627,"LINDOLFO COLLOR","SUL","RIO GRANDE DO SUL","33.3510993",6248,2604,2603,1,"2.7"
4311643,"LINHA NOVA","SUL","RIO GRANDE DO SUL","63.5018666",1683,952,952,0,"2.5"
4311700,"MACHADINHO","SUL","RIO GRANDE DO SUL","335.1980647",5735,3064,3059,5,"2.5"
4311718,"MAÇAMBARÁ","SUL","RIO GRANDE DO SUL","1682.8203045",4425,2283,2279,4,"2.7"
4311734,"MAMPITUBA","SUL","RIO GRANDE DO SUL","156.6533458",3131,1559,1556,3,"2.5"
4311759,"MANOEL VIANA","SUL","RIO GRANDE DO SUL","1390.696173",6801,3456,3452,4,"2.5"
4311775,"MAQUINÉ","SUL","RIO GRANDE DO SUL","613.5800604",7418,5010,4972,38,"2.5"
4311791,"MARATÁ","SUL","RIO GRANDE DO SUL","82.0626088",2470,1311,1311,0,"2.5"
4311809,"MARAU","SUL","RIO GRANDE DO SUL","649.7696676",45124,19725,19705,20,"2.6"
4311908,"MARCELINO RAMOS","SUL","RIO GRANDE DO SUL","229.7594114",4320,2728,2714,14,"2.5"
4311981,"MARIANA PIMENTEL","SUL","RIO GRANDE DO SUL","338.4504272",3916,2390,2382,8,"2.4"
4312005,"MARIANO MORO","SUL","RIO GRANDE DO SUL","98.7274002",1858,1087,1087,0,"2.5"
4312054,"MARQUES DE SOUZA","SUL","RIO GRANDE DO SUL","125.7137516",3969,2276,2273,3,"2.5"
4312104,"MATA","SUL","RIO GRANDE DO SUL","316.120715",4698,2489,2482,7,"2.4"
4312138,"MATO CASTELHANO","SUL","RIO GRANDE DO SUL","238.2684068",2553,1478,1478,0,"2.7"
4312153,"MATO LEITÃO","SUL","RIO GRANDE DO SUL","46.7985392",4859,2168,2165,3,"2.6"
4312179,"MATO QUEIMADO","SUL","RIO GRANDE DO SUL","114.6525736",1795,895,894,1,"2.6"
4312203,"MAXIMILIANO DE ALMEIDA","SUL","RIO GRANDE DO SUL","208.4389746",4191,2055,2054,1,"2.5"
4312252,"MINAS DO LEÃO","SUL","RIO GRANDE DO SUL","424.3389387",7505,3344,3340,4,"2.7"
4312302,"MIRAGUAÍ","SUL","RIO GRANDE DO SUL","131.2357642",4427,1981,1981,0,"2.7"
4312351,"MONTAURI","SUL","RIO GRANDE DO SUL","82.2301862",1499,619,618,1,"2.8"
4312377,"MONTE ALEGRE DOS CAMPOS","SUL","RIO GRANDE DO SUL","549.4552732",3180,1757,1751,6,"2.7"
4312385,"MONTE BELO DO SUL","SUL","RIO GRANDE DO SUL","69.7263003",2557,1200,1200,0,"2.8"
4312401,"MONTENEGRO","SUL","RIO GRANDE DO SUL","425.0233043",64322,28488,28445,43,"2.6"
4312427,"MORMAÇO","SUL","RIO GRANDE DO SUL","146.1906214",2756,1237,1237,0,"2.6"
4312443,"MORRINHOS DO SUL","SUL","RIO GRANDE DO SUL","166.2241664",3071,1653,1653,0,"2.4"
4312450,"MORRO REDONDO","SUL","RIO GRANDE DO SUL","244.6448484",6046,3372,3368,4,"2.4"
4312476,"MORRO REUTER","SUL","RIO GRANDE DO SUL","89.4118448",6029,2994,2994,0,"2.6"
4312500,"MOSTARDAS","SUL","RIO GRANDE DO SUL","1977.4417758",12090,9751,9741,10,"2.6"
4312609,"MUÇUM","SUL","RIO GRANDE DO SUL","111.246965",4601,2273,2270,3,"2.6"
4312617,"MUITOS CAPÕES","SUL","RIO GRANDE DO SUL","1193.230119",2879,1698,1688,10,"2.6"
4312625,"MULITERNO","SUL","RIO GRANDE DO SUL","111.1323399",1721,675,674,1,"2.8"
4312658,"NÃO-ME-TOQUE","SUL","RIO GRANDE DO SUL","361.689009",17898,7755,7745,10,"2.6"
4312674,"NICOLAU VERGUEIRO","SUL","RIO GRANDE DO SUL","154.9945214",1932,1437,1437,0,"2.5"
4312708,"NONOAI","SUL","RIO GRANDE DO SUL","468.9624143",13719,6013,6008,5,"2.7"
4312757,"NOVA ALVORADA","SUL","RIO GRANDE DO SUL","148.8606283",3163,1445,1445,0,"2.7"
4312807,"NOVA ARAÇÁ","SUL","RIO GRANDE DO SUL","75.5135766",4954,2052,2051,1,"2.7"
4312906,"NOVA BASSANO","SUL","RIO GRANDE DO SUL","211.6111706",9649,3953,3948,5,"2.9"
4312955,"NOVA BOA VISTA","SUL","RIO GRANDE DO SUL","93.7329014",2042,878,878,0,"2.6"
4313003,"NOVA BRÉSCIA","SUL","RIO GRANDE DO SUL","102.9943993",3044,1466,1465,1,"2.5"
4313011,"NOVA CANDELÁRIA","SUL","RIO GRANDE DO SUL","97.5791295",3061,1294,1294,0,"2.6"
4313037,"NOVA ESPERANÇA DO SUL","SUL","RIO GRANDE DO SUL","190.9996926",4865,2211,2210,1,"2.6"
4313060,"NOVA HARTZ","SUL","RIO GRANDE DO SUL","62.3194639",20088,8857,8854,3,"2.6"
4313086,"NOVA PÁDUA","SUL","RIO GRANDE DO SUL","102.6434738",2343,1062,1059,3,"2.9"
4313102,"NOVA PALMA","SUL","RIO GRANDE DO SUL","314.6128476",5586,2395,2394,1,"2.7"
4313201,"NOVA PETRÓPOLIS","SUL","RIO GRANDE DO SUL","290.16415",23300,11769,11740,29,"2.6"
4313300,"NOVA PRATA","SUL","RIO GRANDE DO SUL","259.9410953",25692,11714,11707,7,"2.6"
4313334,"NOVA RAMADA","SUL","RIO GRANDE DO SUL","255.264451",2163,988,988,0,"2.5"
4313359,"NOVA ROMA DO SUL","SUL","RIO GRANDE DO SUL","149.7668749",3466,1506,1504,2,"2.8"
4313375,"NOVA SANTA RITA","SUL","RIO GRANDE DO SUL","218.1533062",29024,12256,12249,7,"2.8"
4313391,"NOVO CABRAIS","SUL","RIO GRANDE DO SUL","192.9981482",3568,1912,1912,0,"2.4"
4313409,"NOVO HAMBURGO","SUL","RIO GRANDE DO SUL","222.535976",227646,106318,106224,94,"2.5"
4313425,"NOVO MACHADO","SUL","RIO GRANDE DO SUL","218.8358131",3198,1752,1752,0,"2.4"
4313441,"NOVO TIRADENTES","SUL","RIO GRANDE DO SUL","75.4278744",2146,925,925,0,"2.6"
4313466,"NOVO XINGU","SUL","RIO GRANDE DO SUL","79.850787",1646,723,723,0,"2.6"
4313490,"NOVO BARREIRO","SUL","RIO GRANDE DO SUL","123.3441384",4272,1898,1898,0,"2.6"
4313508,"OSÓRIO","SUL","RIO GRANDE DO SUL","663.8777526",47396,26361,26324,37,"2.6"
4313607,"PAIM FILHO","SUL","RIO GRANDE DO SUL","182.1153655",3629,1740,1740,0,"2.6"
4313656,"PALMARES DO SUL","SUL","RIO GRANDE DO SUL","949.200952",12844,16429,16391,38,"2.5"
4313706,"PALMEIRA DAS MISSÕES","SUL","RIO GRANDE DO SUL","1421.1012821",33216,15008,14990,18,"2.6"
4313805,"PALMITINHO","SUL","RIO GRANDE DO SUL","144.1813951",7839,3585,3582,3,"2.6"
4313904,"PANAMBI","SUL","RIO GRANDE DO SUL","491.5699198",43515,17885,17875,10,"2.6"
4313953,"PANTANO GRANDE","SUL","RIO GRANDE DO SUL","841.2253154",10212,4767,4760,7,"2.6"
4314001,"PARAÍ","SUL","RIO GRANDE DO SUL","121.7450985",7194,2985,2982,3,"2.7"
4314027,"PARAÍSO DO SUL","SUL","RIO GRANDE DO SUL","337.5338785",6519,3351,3349,2,"2.5"
4314035,"PARECI NOVO","SUL","RIO GRANDE DO SUL","57.4845748",4319,2032,2031,1,"2.6"
4314050,"PAROBÉ","SUL","RIO GRANDE DO SUL","108.7072018",52058,22833,22818,15,"2.6"
4314068,"PASSA SETE","SUL","RIO GRANDE DO SUL","304.2658148",3983,1885,1881,4,"2.6"
4314076,"PASSO DO SOBRADO","SUL","RIO GRANDE DO SUL","265.1333305",6025,2956,2955,1,"2.5"
4314100,"PASSO FUNDO","SUL","RIO GRANDE DO SUL","784.4064883",206215,95786,95690,96,"2.5"
4314134,"PAULO BENTO","SUL","RIO GRANDE DO SUL","149.669048",2144,995,995,0,"2.7"
4314159,"PAVERAMA","SUL","RIO GRANDE DO SUL","171.8633697",7978,4078,4076,2,"2.5"
4314175,"PEDRAS ALTAS","SUL","RIO GRANDE DO SUL","1373.985067",2061,1190,1189,1,"2.4"
4314209,"PEDRO OSÓRIO","SUL","RIO GRANDE DO SUL","603.7567646",7484,3874,3871,3,"2.4"
4314308,"PEJUÇARA","SUL","RIO GRANDE DO SUL","414.1058767",3745,1607,1607,0,"2.7"
4314407,"PELOTAS","SUL","RIO GRANDE DO SUL","1608.7797433",325685,166058,165896,162,"2.5"
4314423,"PICADA CAFÉ","SUL","RIO GRANDE DO SUL","84.2804188",5351,2552,2552,0,"2.6"
4314456,"PINHAL","SUL","RIO GRANDE DO SUL","68.2218462",2959,1189,1189,0,"2.7"
4314464,"PINHAL DA SERRA","SUL","RIO GRANDE DO SUL","438.1096188",2248,1206,1206,0,"2.5"
4314472,"PINHAL GRANDE","SUL","RIO GRANDE DO SUL","478.1101264",3805,1768,1767,1,"2.6"
4314498,"PINHEIRINHO DO VALE","SUL","RIO GRANDE DO SUL","105.3852941",4540,1996,1995,1,"2.7"
4314506,"PINHEIRO MACHADO","SUL","RIO GRANDE DO SUL","2249.1755587",11214,6556,6550,6,"2.3"
4314548,"PINTO BANDEIRA","SUL","RIO GRANDE DO SUL","104.8010338",2723,1267,1261,6,"2.9"
4314555,"PIRAPÓ","SUL","RIO GRANDE DO SUL","293.7232538",2260,1168,1167,1,"2.5"
4314605,"PIRATINI","SUL","RIO GRANDE DO SUL","3538.3003074",17504,10863,10859,4,"2.3"
4314704,"PLANALTO","SUL","RIO GRANDE DO SUL","228.5516117",10406,4653,4641,12,"2.6"
4314753,"POÇO DAS ANTAS","SUL","RIO GRANDE DO SUL","67.6182257",2171,1043,1043,0,"2.6"
4314779,"PONTÃO","SUL","RIO GRANDE DO SUL","502.7094483",3296,1517,1516,1,"2.6"
4314787,"PONTE PRETA","SUL","RIO GRANDE DO SUL","99.5044207",1575,707,707,0,"2.7"
4314803,"PORTÃO","SUL","RIO GRANDE DO SUL","159.2984984",34071,15341,15319,22,"2.6"
4314902,"PORTO ALEGRE","SUL","RIO GRANDE DO SUL","495.3901657",1332845,687679,686846,833,"2.4"
4315008,"PORTO LUCENA","SUL","RIO GRANDE DO SUL","250.8756194",4360,2396,2395,1,"2.4"
4315057,"PORTO MAUÁ","SUL","RIO GRANDE DO SUL","105.8106798",2142,1234,1232,2,"2.5"
4315073,"PORTO VERA CRUZ","SUL","RIO GRANDE DO SUL","114.2839193",1560,1009,1009,0,"2.3"
4315107,"PORTO XAVIER","SUL","RIO GRANDE DO SUL","281.4966426",9938,4717,4711,6,"2.5"
4315131,"POUSO NOVO","SUL","RIO GRANDE DO SUL","105.3382408",1739,801,799,2,"2.6"
4315149,"PRESIDENTE LUCENA","SUL","RIO GRANDE DO SUL","49.6278407",3077,1391,1391,0,"2.8"
4315156,"PROGRESSO","SUL","RIO GRANDE DO SUL","256.0389037",5340,2723,2721,2,"2.5"
4315172,"PROTÁSIO ALVES","SUL","RIO GRANDE DO SUL","171.9940784",2025,950,946,4,"2.7"
4315206,"PUTINGA","SUL","RIO GRANDE DO SUL","216.1594826",3747,1745,1745,0,"2.7"
4315305,"QUARAÍ","SUL","RIO GRANDE DO SUL","3139.9948044",23500,10135,10114,21,"2.7"
4315313,"QUATRO IRMÃOS","SUL","RIO GRANDE DO SUL","268.9706246",1552,799,799,0,"2.7"
4315321,"QUEVEDOS","SUL","RIO GRANDE DO SUL","543.358974",2507,1332,1332,0,"2.4"
4315354,"QUINZE DE NOVEMBRO","SUL","RIO GRANDE DO SUL","223.072136",3910,2163,2163,0,"2.6"
4315404,"REDENTORA","SUL","RIO GRANDE DO SUL","303.7051256",9738,3426,3424,2,"3.1"
4315453,"RELVADO","SUL","RIO GRANDE DO SUL","108.188156",1796,869,867,2,"2.6"
4315503,"RESTINGA SÊCA","SUL","RIO GRANDE DO SUL","968.6204652",14939,7937,7925,12,"2.5"
4315552,"RIO DOS ÍNDIOS","SUL","RIO GRANDE DO SUL","235.8542244",2835,1389,1389,0,"2.6"
4315602,"RIO GRANDE","SUL","RIO GRANDE DO SUL","2682.8669237",191900,102932,102802,130,"2.6"
4315701,"RIO PARDO","SUL","RIO GRANDE DO SUL","2051.1115672",34654,18118,18103,15,"2.5"
4315750,"RIOZINHO","SUL","RIO GRANDE DO SUL","239.0904384",4473,2469,2464,5,"2.6"
4315800,"ROCA SALES","SUL","RIO GRANDE DO SUL","208.1080803",10418,4860,4853,7,"2.6"
4315909,"RODEIO BONITO","SUL","RIO GRANDE DO SUL","83.2777959",6654,2881,2876,5,"2.6"
4315958,"ROLADOR","SUL","RIO GRANDE DO SUL","295.3264936",2291,1266,1266,0,"2.5"
4316006,"ROLANTE","SUL","RIO GRANDE DO SUL","296.0903794",21253,10423,10419,4,"2.6"
4316105,"RONDA ALTA","SUL","RIO GRANDE DO SUL","418.674663",9777,4372,4365,7,"2.7"
4316204,"RONDINHA","SUL","RIO GRANDE DO SUL","252.4537434",4991,2020,2018,2,"2.8"
4316303,"ROQUE GONZALES","SUL","RIO GRANDE DO SUL","349.0743102",6576,3181,3180,1,"2.5"
4316402,"ROSÁRIO DO SUL","SUL","RIO GRANDE DO SUL","4343.6559177",36630,16263,16247,16,"2.6"
4316428,"SAGRADA FAMÍLIA","SUL","RIO GRANDE DO SUL","77.8891597",2480,1150,1150,0,"2.5"
4316436,"SALDANHA MARINHO","SUL","RIO GRANDE DO SUL","221.5538307",2575,1258,1255,3,"2.5"
4316451,"SALTO DO JACUÍ","SUL","RIO GRANDE DO SUL","507.6981673",10203,4978,4974,4,"2.5"
4316477,"SALVADOR DAS MISSÕES","SUL","RIO GRANDE DO SUL","94.311965",2877,1310,1309,1,"2.6"
4316501,"SALVADOR DO SUL","SUL","RIO GRANDE DO SUL","99.1565344",6879,3134,3131,3,"2.6"
4316600,"SANANDUVA","SUL","RIO GRANDE DO SUL","504.4383238",16399,7707,7702,5,"2.5"
4316709,"SANTA BÁRBARA DO SUL","SUL","RIO GRANDE DO SUL","975.7986483",8122,3764,3759,5,"2.5"
4316733,"SANTA CECÍLIA DO SUL","SUL","RIO GRANDE DO SUL","200.0558112",1674,742,742,0,"2.7"
4316758,"SANTA CLARA DO SUL","SUL","RIO GRANDE DO SUL","86.4418257",6887,2996,2993,3,"2.6"
4316808,"SANTA CRUZ DO SUL","SUL","RIO GRANDE DO SUL","733.8977994",133230,61255,61148,107,"2.5"
4316907,"SANTA MARIA","SUL","RIO GRANDE DO SUL","1780.1935733",271735,132595,131912,683,"2.5"
4316956,"SANTA MARIA DO HERVAL","SUL","RIO GRANDE DO SUL","140.4367586",6340,3111,3111,0,"2.6"
4316972,"SANTA MARGARIDA DO SUL","SUL","RIO GRANDE DO SUL","955.2990138",2596,1378,1377,1,"2.5"
4317004,"SANTANA DA BOA VISTA","SUL","RIO GRANDE DO SUL","1418.8051041",7024,4877,4874,3,"2.3"
4317103,"SANT'ANA DO LIVRAMENTO","SUL","RIO GRANDE DO SUL","6946.406941",84421,37350,37298,52,"2.6"
4317202,"SANTA ROSA","SUL","RIO GRANDE DO SUL","489.3800269",76963,33614,33587,27,"2.5"
4317251,"SANTA TEREZA","SUL","RIO GRANDE DO SUL","73.6689432",1505,894,890,4,"2.5"
4317301,"SANTA VITÓRIA DO PALMAR","SUL","RIO GRANDE DO SUL","5206.9769969",30983,20837,20788,49,"2.5"
4317400,"SANTIAGO","SUL","RIO GRANDE DO SUL","2414.1952189",48938,22808,22783,25,"2.5"
4317509,"SANTO ÂNGELO","SUL","RIO GRANDE DO SUL","679.3395557",76917,34602,34553,49,"2.6"
4317558,"SANTO ANTÔNIO DO PALMA","SUL","RIO GRANDE DO SUL","126.0944139",2091,905,905,0,"2.8"
4317608,"SANTO ANTÔNIO DA PATRULHA","SUL","RIO GRANDE DO SUL","1049.5832204",42947,22394,22367,27,"2.5"
4317707,"SANTO ANTÔNIO DAS MISSÕES","SUL","RIO GRANDE DO SUL","1710.868951",10300,5093,5091,2,"2.5"
4317756,"SANTO ANTÔNIO DO PLANALTO","SUL","RIO GRANDE DO SUL","203.4401597",2089,1002,1001,1,"2.6"
4317806,"SANTO AUGUSTO","SUL","RIO GRANDE DO SUL","467.7747388",13902,6203,6202,1,"2.5"
4317905,"SANTO CRISTO","SUL","RIO GRANDE DO SUL","367.202146",15320,6599,6592,7,"2.6"
4317954,"SANTO EXPEDITO DO SUL","SUL","RIO GRANDE DO SUL","125.5953006",2349,1104,1104,0,"2.6"
4318002,"SÃO BORJA","SUL","RIO GRANDE DO SUL","3616.6900192",59676,25174,25141,33,"2.6"
4318051,"SÃO DOMINGOS DO SUL","SUL","RIO GRANDE DO SUL","78.6702845",2754,1254,1252,2,"2.6"
4318101,"SÃO FRANCISCO DE ASSIS","SUL","RIO GRANDE DO SUL","2506.9753709",17618,9251,9239,12,"2.4"
4318200,"SÃO FRANCISCO DE PAULA","SUL","RIO GRANDE DO SUL","3317.7941565",21893,12408,12364,44,"2.6"
4318309,"SÃO GABRIEL","SUL","RIO GRANDE DO SUL","5053.4601298",58487,26993,26961,32,"2.6"
4318408,"SÃO JERÔNIMO","SUL","RIO GRANDE DO SUL","935.5955309",21028,10135,10125,10,"2.6"
4318424,"SÃO JOÃO DA URTIGA","SUL","RIO GRANDE DO SUL","171.0287695",4461,2126,2126,0,"2.6"
4318432,"SÃO JOÃO DO POLÊSINE","SUL","RIO GRANDE DO SUL","78.3197932",2649,1223,1222,1,"2.5"
4318440,"SÃO JORGE","SUL","RIO GRANDE DO SUL","125.6201566",2912,1308,1305,3,"2.7"
4318457,"SÃO JOSÉ DAS MISSÕES","SUL","RIO GRANDE DO SUL","98.1248703",2362,1073,1073,0,"2.5"
4318465,"SÃO JOSÉ DO HERVAL","SUL","RIO GRANDE DO SUL","102.9118445",1902,986,986,0,"2.5"
4318481,"SÃO JOSÉ DO HORTÊNCIO","SUL","RIO GRANDE DO SUL","63.7086835",4447,1972,1972,0,"2.6"
4318499,"SÃO JOSÉ DO INHACORÁ","SUL","RIO GRANDE DO SUL","77.7320596",2406,1091,1091,0,"2.5"
4318507,"SÃO JOSÉ DO NORTE","SUL","RIO GRANDE DO SUL","1071.8244857",25443,15096,15078,18,"2.5"
4318606,"SÃO JOSÉ DO OURO","SUL","RIO GRANDE DO SUL","335.2873934",6834,3176,3176,0,"2.5"
4318614,"SÃO JOSÉ DO SUL","SUL","RIO GRANDE DO SUL","54.7638464",2380,1121,1120,1,"2.6"
4318622,"SÃO JOSÉ DOS AUSENTES","SUL","RIO GRANDE DO SUL","1173.9066222",4172,1962,1948,14,"2.9"
4318705,"SÃO LEOPOLDO","SUL","RIO GRANDE DO SUL","103.0086587",217409,98238,98150,88,"2.6"
4318804,"SÃO LOURENÇO DO SUL","SUL","RIO GRANDE DO SUL","2036.1251391",41989,19100,19072,28,"2.7"
4318903,"SÃO LUIZ GONZAGA","SUL","RIO GRANDE DO SUL","1295.5219655",34752,15676,15659,17,"2.5"
4319000,"SÃO MARCOS","SUL","RIO GRANDE DO SUL","256.1588803",21084,9777,9773,4,"2.6"
4319109,"SÃO MARTINHO","SUL","RIO GRANDE DO SUL","171.2449575",5481,2578,2577,1,"2.5"
4319125,"SÃO MARTINHO DA SERRA","SUL","RIO GRANDE DO SUL","669.5472156",2860,1767,1767,0,"2.5"
4319158,"SÃO MIGUEL DAS MISSÕES","SUL","RIO GRANDE DO SUL","1228.447095",7056,3638,3630,8,"2.5"
4319208,"SÃO NICOLAU","SUL","RIO GRANDE DO SUL","485.5876163",5118,2616,2612,4,"2.5"
4319307,"SÃO PAULO DAS MISSÕES","SUL","RIO GRANDE DO SUL","223.9422052",5846,2699,2696,3,"2.6"
4319356,"SÃO PEDRO DA SERRA","SUL","RIO GRANDE DO SUL","35.2066032",3548,1524,1524,0,"2.7"
4319364,"SÃO PEDRO DAS MISSÕES","SUL","RIO GRANDE DO SUL","79.8940741",1757,779,779,0,"2.6"
4319372,"SÃO PEDRO DO BUTIÁ","SUL","RIO GRANDE DO SUL","107.5585021",3070,1288,1284,4,"2.6"
4319406,"SÃO PEDRO DO SUL","SUL","RIO GRANDE DO SUL","873.393709",15577,8035,8030,5,"2.4"
4319505,"SÃO SEBASTIÃO DO CAÍ","SUL","RIO GRANDE DO SUL","114.2931556",24428,11515,11506,9,"2.6"
4319604,"SÃO SEPÉ","SUL","RIO GRANDE DO SUL","2204.7792588",21219,11247,11237,10,"2.4"
4319703,"SÃO VALENTIM","SUL","RIO GRANDE DO SUL","154.4499586",3264,1542,1541,1,"2.6"
4319711,"SÃO VALENTIM DO SUL","SUL","RIO GRANDE DO SUL","91.8977747",2207,1313,1313,0,"2.6"
4319737,"SÃO VALÉRIO DO SUL","SUL","RIO GRANDE DO SUL","107.4020532",2543,937,937,0,"3.1"
4319752,"SÃO VENDELINO","SUL","RIO GRANDE DO SUL","31.9350126",2251,1027,1027,0,"2.6"
4319802,"SÃO VICENTE DO SUL","SUL","RIO GRANDE DO SUL","1174.8223884",8097,4247,4208,39,"2.6"
4319901,"SAPIRANGA","SUL","RIO GRANDE DO SUL","136.4733471",75648,32510,32489,21,"2.6"
4320008,"SAPUCAIA DO SUL","SUL","RIO GRANDE DO SUL","58.2468308",132107,57410,57394,16,"2.6"
4320107,"SARANDI","SUL","RIO GRANDE DO SUL","351.717503",22851,9559,9549,10,"2.6"
4320206,"SEBERI","SUL","RIO GRANDE DO SUL","300.8266745",11950,5501,5494,7,"2.5"
4320230,"SEDE NOVA","SUL","RIO GRANDE DO SUL","119.3117064",2704,1220,1219,1,"2.5"
4320263,"SEGREDO","SUL","RIO GRANDE DO SUL","245.1699955",6009,2719,2719,0,"2.6"
4320305,"SELBACH","SUL","RIO GRANDE DO SUL","176.4704937",5107,2194,2189,5,"2.6"
4320321,"SENADOR SALGADO FILHO","SUL","RIO GRANDE DO SUL","147.0681433",2673,1274,1274,0,"2.6"
4320354,"SENTINELA DO SUL","SUL","RIO GRANDE DO SUL","282.1296878",5306,2965,2960,5,"2.5"
4320404,"SERAFINA CORRÊA","SUL","RIO GRANDE DO SUL","163.3103566",16961,6939,6935,4,"2.7"
4320453,"SÉRIO","SUL","RIO GRANDE DO SUL","98.13053",1941,984,981,3,"2.5"
4320503,"SERTÃO","SUL","RIO GRANDE DO SUL","440.6308985",5541,2817,2809,8,"2.5"
4320552,"SERTÃO SANTANA","SUL","RIO GRANDE DO SUL","252.0125978",5863,3098,3095,3,"2.5"
4320578,"SETE DE SETEMBRO","SUL","RIO GRANDE DO SUL","129.2382624",1830,832,831,1,"2.6"
4320602,"SEVERIANO DE ALMEIDA","SUL","RIO GRANDE DO SUL","167.5980674",3406,1731,1729,2,"2.6"
4320651,"SILVEIRA MARTINS","SUL","RIO GRANDE DO SUL","119.2853241",2028,1075,1073,2,"2.6"
4320677,"SINIMBU","SUL","RIO GRANDE DO SUL","510.2129517",8578,4043,4040,3,"2.7"
4320701,"SOBRADINHO","SUL","RIO GRANDE DO SUL","128.8227931",14226,6430,6419,11,"2.5"
4320800,"SOLEDADE","SUL","RIO GRANDE DO SUL","1215.0555962",29991,13831,13817,14,"2.5"
4320859,"TABAÍ","SUL","RIO GRANDE DO SUL","94.7543515",4461,2237,2237,0,"2.6"
4320909,"TAPEJARA","SUL","RIO GRANDE DO SUL","238.0815414",24557,10309,10300,9,"2.6"
4321006,"TAPERA","SUL","RIO GRANDE DO SUL","179.9351005",10592,4492,4489,3,"2.6"
4321105,"TAPES","SUL","RIO GRANDE DO SUL","805.4521642",14695,8696,8686,10,"2.4"
4321204,"TAQUARA","SUL","RIO GRANDE DO SUL","452.5722915",53242,26859,26826,33,"2.5"
4321303,"TAQUARI","SUL","RIO GRANDE DO SUL","349.9668292",25198,12189,12175,14,"2.5"
4321329,"TAQUARUÇU DO SUL","SUL","RIO GRANDE DO SUL","76.9172108",3119,1356,1354,2,"2.7"
4321352,"TAVARES","SUL","RIO GRANDE DO SUL","610.106767",5212,3471,3464,7,"2.4"
4321402,"TENENTE PORTELA","SUL","RIO GRANDE DO SUL","337.4954262",14497,6016,6010,6,"2.7"
4321436,"TERRA DE AREIA","SUL","RIO GRANDE DO SUL","142.3041121",10334,6286,6284,2,"2.6"
4321451,"TEUTÔNIA","SUL","RIO GRANDE DO SUL","177.7953415",32797,14303,14286,17,"2.6"
4321469,"TIO HUGO","SUL","RIO GRANDE DO SUL","113.9438426",3267,1567,1564,3,"2.6"
4321477,"TIRADENTES DO SUL","SUL","RIO GRANDE DO SUL","236.6529873",5129,2487,2486,1,"2.5"
4321493,"TOROPI","SUL","RIO GRANDE DO SUL","198.3159337",2554,1546,1546,0,"2.4"
4321501,"TORRES","SUL","RIO GRANDE DO SUL","161.6300613",41751,32149,32049,100,"2.5"
4321600,"TRAMANDAÍ","SUL","RIO GRANDE DO SUL","142.8777081",54387,49316,49125,191,"2.6"
4321626,"TRAVESSEIRO","SUL","RIO GRANDE DO SUL","80.680853",2152,1090,1090,0,"2.6"
4321634,"TRÊS ARROIOS","SUL","RIO GRANDE DO SUL","148.6011038",2591,1271,1270,1,"2.5"
4321667,"TRÊS CACHOEIRAS","SUL","RIO GRANDE DO SUL","251.4828839",10962,5012,5010,2,"2.6"
4321709,"TRÊS COROAS","SUL","RIO GRANDE DO SUL","165.2851569",24425,11088,11068,20,"2.6"
4321808,"TRÊS DE MAIO","SUL","RIO GRANDE DO SUL","421.4607836",24916,11036,11024,12,"2.5"
4321832,"TRÊS FORQUILHAS","SUL","RIO GRANDE DO SUL","217.3857832",2760,1560,1560,0,"2.6"
4321857,"TRÊS PALMEIRAS","SUL","RIO GRANDE DO SUL","180.5990924",4716,2017,2017,0,"2.7"
4321907,"TRÊS PASSOS","SUL","RIO GRANDE DO SUL","268.90181",25436,11224,11218,6,"2.5"
4321956,"TRINDADE DO SUL","SUL","RIO GRANDE DO SUL","268.4172932",7556,3445,3444,1,"2.7"
4322004,"TRIUNFO","SUL","RIO GRANDE DO SUL","817.6250182",27498,13318,13298,20,"2.6"
4322103,"TUCUNDUVA","SUL","RIO GRANDE DO SUL","181.1977887",5542,2558,2554,4,"2.4"
4322152,"TUNAS","SUL","RIO GRANDE DO SUL","217.302167",3681,1679,1679,0,"2.6"
4322186,"TUPANCI DO SUL","SUL","RIO GRANDE DO SUL","135.2430589",1374,682,682,0,"2.4"
4322202,"TUPANCIRETÃ","SUL","RIO GRANDE DO SUL","2253.2344593",20005,9606,9595,11,"2.6"
4322251,"TUPANDI","SUL","RIO GRANDE DO SUL","59.4465477",5029,2131,2131,0,"2.7"
4322301,"TUPARENDI","SUL","RIO GRANDE DO SUL","307.7102512",8363,3833,3832,1,"2.5"
4322327,"TURUÇU","SUL","RIO GRANDE DO SUL","253.6350065",3419,1497,1497,0,"2.8"
4322343,"UBIRETAMA","SUL","RIO GRANDE DO SUL","125.8756432",1994,874,874,0,"2.6"
4322350,"UNIÃO DA SERRA","SUL","RIO GRANDE DO SUL","131.153939",1170,578,578,0,"2.7"
4322376,"UNISTALDA","SUL","RIO GRANDE DO SUL","602.3872709",1995,1083,1080,3,"2.5"
4322400,"URUGUAIANA","SUL","RIO GRANDE DO SUL","5702.097797",117210,47276,47193,83,"2.8"
4322509,"VACARIA","SUL","RIO GRANDE DO SUL","2124.4919789",64197,27701,27647,54,"2.7"
4322525,"VALE VERDE","SUL","RIO GRANDE DO SUL","329.726845",3150,2059,2058,1,"2.4"
4322533,"VALE DO SOL","SUL","RIO GRANDE DO SUL","328.2747768",9897,4565,4561,4,"2.6"
4322541,"VALE REAL","SUL","RIO GRANDE DO SUL","45.0853215",6058,2682,2682,0,"2.7"
4322558,"VANINI","SUL","RIO GRANDE DO SUL","64.9047783",2004,913,912,1,"2.5"
4322608,"VENÂNCIO AIRES","SUL","RIO GRANDE DO SUL","772.5880458",68763,32569,32548,21,"2.5"
4322707,"VERA CRUZ","SUL","RIO GRANDE DO SUL","309.6207712",26710,11913,11904,9,"2.6"
4322806,"VERANÓPOLIS","SUL","RIO GRANDE DO SUL","289.3965137",24021,11225,11212,13,"2.5"
4322855,"VESPASIANO CORRÊA","SUL","RIO GRANDE DO SUL","113.6219435",1818,815,815,0,"2.8"
4322905,"VIADUTOS","SUL","RIO GRANDE DO SUL","268.0720773",4769,2293,2292,1,"2.5"
4323002,"VIAMÃO","SUL","RIO GRANDE DO SUL","1496.5055403",224112,107264,107189,75,"2.6"
4323101,"VICENTE DUTRA","SUL","RIO GRANDE DO SUL","193.0252674",4665,2379,2377,2,"2.6"
4323200,"VICTOR GRAEFF","SUL","RIO GRANDE DO SUL","238.1329102",2780,1328,1328,0,"2.5"
4323309,"VILA FLORES","SUL","RIO GRANDE DO SUL","107.7025825",3646,1668,1664,4,"2.7"
4323358,"VILA LÂNGARO","SUL","RIO GRANDE DO SUL","151.6952113",2079,934,934,0,"2.7"
4323408,"VILA MARIA","SUL","RIO GRANDE DO SUL","181.061331",4413,2002,2002,0,"2.7"
4323457,"VILA NOVA DO SUL","SUL","RIO GRANDE DO SUL","508.2778084",3863,2168,2166,2,"2.4"
4323507,"VISTA ALEGRE","SUL","RIO GRANDE DO SUL","77.6302297",2660,1166,1165,1,"2.6"
4323606,"VISTA ALEGRE DO PRATA","SUL","RIO GRANDE DO SUL","119.3272633",1590,772,772,0,"2.8"
4323705,"VISTA GAÚCHA","SUL","RIO GRANDE DO SUL","90.0216973",2783,1282,1281,1,"2.5"
4323754,"VITÓRIA DAS MISSÕES","SUL","RIO GRANDE DO SUL","258.3116342",3260,1814,1814,0,"2.5"
4323770,"WESTFÁLIA","SUL","RIO GRANDE DO SUL","63.6653498",3098,1277,1277,0,"2.8"
4323804,"XANGRI-LÁ","SUL","RIO GRANDE DO SUL","60.7564161",16463,23058,23049,9,"2.8"
5000203,"ÁGUA CLARA","CENTRO-OESTE","MATO GROSSO DO SUL","7781.5578172",16741,7335,7179,156,"3"
5000252,"ALCINÓPOLIS","CENTRO-OESTE","MATO GROSSO DO SUL","4397.5181313",4537,2632,2619,13,"2.6"
5000609,"AMAMBAI","CENTRO-OESTE","MATO GROSSO DO SUL","4193.7415833",39325,15691,15666,25,"2.9"
5000708,"ANASTÁCIO","CENTRO-OESTE","MATO GROSSO DO SUL","2913.1079168",24114,10844,10815,29,"2.8"
5000807,"ANAURILÂNDIA","CENTRO-OESTE","MATO GROSSO DO SUL","3415.6566926",7653,4351,4342,9,"2.6"
5000856,"ANGÉLICA","CENTRO-OESTE","MATO GROSSO DO SUL","1283.6268663",10729,5030,5023,7,"2.7"
5000906,"ANTÔNIO JOÃO","CENTRO-OESTE","MATO GROSSO DO SUL","1142.5306037",9303,3903,3897,6,"2.9"
5001003,"APARECIDA DO TABOADO","CENTRO-OESTE","MATO GROSSO DO SUL","2751.485332",27674,13351,13327,24,"2.7"
5001102,"AQUIDAUANA","CENTRO-OESTE","MATO GROSSO DO SUL","17088.3958676",46803,21169,21141,28,"2.9"
5001243,"ARAL MOREIRA","CENTRO-OESTE","MATO GROSSO DO SUL","1653.8596661",10748,3855,3846,9,"3.2"
5001508,"BANDEIRANTES","CENTRO-OESTE","MATO GROSSO DO SUL","3357.9264713",7940,4265,4247,18,"2.7"
5001904,"BATAGUASSU","CENTRO-OESTE","MATO GROSSO DO SUL","2392.4762776",23031,10525,10502,23,"2.8"
5002001,"BATAYPORÃ","CENTRO-OESTE","MATO GROSSO DO SUL","1826.5782729",10712,4836,4824,12,"2.8"
5002100,"BELA VISTA","CENTRO-OESTE","MATO GROSSO DO SUL","4909.8417718",21613,9239,9150,89,"3"
5002159,"BODOQUENA","CENTRO-OESTE","MATO GROSSO DO SUL","2589.1399807",8567,4064,4052,12,"2.8"
5002209,"BONITO","CENTRO-OESTE","MATO GROSSO DO SUL","5378.9394772",23659,11326,11164,162,"2.8"
5002308,"BRASILÂNDIA","CENTRO-OESTE","MATO GROSSO DO SUL","5803.5422677",11579,6525,6500,25,"2.7"
5002407,"CAARAPÓ","CENTRO-OESTE","MATO GROSSO DO SUL","2115.7302242",30612,11719,11712,7,"2.9"
5002605,"CAMAPUÃ","CENTRO-OESTE","MATO GROSSO DO SUL","6238.1271169",13583,6803,6793,10,"2.5"
5002704,"CAMPO GRANDE","CENTRO-OESTE","MATO GROSSO DO SUL","8082.3271321",898100,392791,392472,319,"2.7"
5002803,"CARACOL","CENTRO-OESTE","MATO GROSSO DO SUL","2928.7064738",5036,2478,2466,12,"2.9"
5002902,"CASSILÂNDIA","CENTRO-OESTE","MATO GROSSO DO SUL","3658.2520067",20988,10536,10518,18,"2.5"
5002951,"CHAPADÃO DO SUL","CENTRO-OESTE","MATO GROSSO DO SUL","3252.3270664",30993,12885,12778,107,"2.8"
5003108,"CORGUINHO","CENTRO-OESTE","MATO GROSSO DO SUL","2639.6564801",4783,3480,3466,14,"2.6"
5003157,"CORONEL SAPUCAIA","CENTRO-OESTE","MATO GROSSO DO SUL","1023.7271966",14289,5041,5031,10,"3.2"
5003207,"CORUMBÁ","CENTRO-OESTE","MATO GROSSO DO SUL","64432.4348814",96268,38050,37943,107,"3.2"
5003256,"COSTA RICA","CENTRO-OESTE","MATO GROSSO DO SUL","4159.3839308",26037,11104,11069,35,"2.8"
5003306,"COXIM","CENTRO-OESTE","MATO GROSSO DO SUL","6388.9671395",32151,16101,16026,75,"2.6"
5003454,"DEODÁPOLIS","CENTRO-OESTE","MATO GROSSO DO SUL","828.4502419",13663,6387,6383,4,"2.7"
5003488,"DOIS IRMÃOS DO BURITI","CENTRO-OESTE","MATO GROSSO DO SUL","2430.3003055",11100,5090,5072,18,"2.9"
5003504,"DOURADINA","CENTRO-OESTE","MATO GROSSO DO SUL","280.1793834",5578,2334,2332,2,"2.8"
5003702,"DOURADOS","CENTRO-OESTE","MATO GROSSO DO SUL","4062.8890526",243367,103076,102948,128,"2.8"
5003751,"ELDORADO","CENTRO-OESTE","MATO GROSSO DO SUL","1012.7962823",11386,5059,5044,15,"2.7"
5003801,"FÁTIMA DO SUL","CENTRO-OESTE","MATO GROSSO DO SUL","315.7369582",20609,9398,9391,7,"2.6"
5003900,"FIGUEIRÃO","CENTRO-OESTE","MATO GROSSO DO SUL","4880.7359393",3539,1863,1844,19,"2.6"
5004007,"GLÓRIA DE DOURADOS","CENTRO-OESTE","MATO GROSSO DO SUL","493.1053819",10444,4891,4886,5,"2.6"
5004106,"GUIA LOPES DA LAGUNA","CENTRO-OESTE","MATO GROSSO DO SUL","1225.4262764",9940,4885,4873,12,"2.8"
5004304,"IGUATEMI","CENTRO-OESTE","MATO GROSSO DO SUL","2957.4096373",13808,6366,6359,7,"2.7"
5004403,"INOCÊNCIA","CENTRO-OESTE","MATO GROSSO DO SUL","5761.19023",8404,4408,4370,38,"2.7"
5004502,"ITAPORÃ","CENTRO-OESTE","MATO GROSSO DO SUL","1342.3886105",24137,9457,9454,3,"2.9"
5004601,"ITAQUIRAÍ","CENTRO-OESTE","MATO GROSSO DO SUL","2063.7165688",19423,8388,8385,3,"2.8"
5004700,"IVINHEMA","CENTRO-OESTE","MATO GROSSO DO SUL","2003.4300333",27821,12215,12199,16,"2.7"
5004809,"JAPORÃ","CENTRO-OESTE","MATO GROSSO DO SUL","416.6053665",8148,2952,2952,0,"3.3"
5004908,"JARAGUARI","CENTRO-OESTE","MATO GROSSO DO SUL","2913.558016",7139,4573,4567,6,"2.6"
5005004,"JARDIM","CENTRO-OESTE","MATO GROSSO DO SUL","2129.9431737",23981,10344,10321,23,"2.9"
5005103,"JATEÍ","CENTRO-OESTE","MATO GROSSO DO SUL","1933.3163354",3586,1896,1894,2,"2.8"
5005152,"JUTI","CENTRO-OESTE","MATO GROSSO DO SUL","1569.1755795",6729,3034,3031,3,"2.8"
5005202,"LADÁRIO","CENTRO-OESTE","MATO GROSSO DO SUL","354.2554191",21522,7324,7315,9,"3.4"
5005251,"LAGUNA CARAPÃ","CENTRO-OESTE","MATO GROSSO DO SUL","1725.7801869",6799,2755,2748,7,"2.9"
5005400,"MARACAJU","CENTRO-OESTE","MATO GROSSO DO SUL","5396.9053509",45047,17272,17211,61,"2.8"
5005608,"MIRANDA","CENTRO-OESTE","MATO GROSSO DO SUL","5470.9747956",25536,10099,10031,68,"3.2"
5005681,"MUNDO NOVO","CENTRO-OESTE","MATO GROSSO DO SUL","478.379788",19193,8390,8365,25,"2.7"
5005707,"NAVIRAÍ","CENTRO-OESTE","MATO GROSSO DO SUL","3189.6671144",50457,22526,22499,27,"2.7"
5005806,"NIOAQUE","CENTRO-OESTE","MATO GROSSO DO SUL","3909.7377926",13220,6501,6478,23,"2.8"
5006002,"NOVA ALVORADA DO SUL","CENTRO-OESTE","MATO GROSSO DO SUL","4025.0120237",21822,9647,9611,36,"2.8"
5006200,"NOVA ANDRADINA","CENTRO-OESTE","MATO GROSSO DO SUL","4770.684813",48563,21566,21536,30,"2.7"
5006259,"NOVO HORIZONTE DO SUL","CENTRO-OESTE","MATO GROSSO DO SUL","849.1896137",4721,2300,2295,5,"2.6"
5006275,"PARAÍSO DAS ÁGUAS","CENTRO-OESTE","MATO GROSSO DO SUL","5061.4326634",5510,2943,2891,52,"2.8"
5006309,"PARANAÍBA","CENTRO-OESTE","MATO GROSSO DO SUL","5405.4789313",40957,20136,20095,41,"2.6"
5006358,"PARANHOS","CENTRO-OESTE","MATO GROSSO DO SUL","1307.091641",12921,4310,4303,7,"3.5"
5006408,"PEDRO GOMES","CENTRO-OESTE","MATO GROSSO DO SUL","3553.7823634",6941,3894,3863,31,"2.5"
5006606,"PONTA PORÃ","CENTRO-OESTE","MATO GROSSO DO SUL","5359.2736179",92017,37658,37578,80,"3"
5006903,"PORTO MURTINHO","CENTRO-OESTE","MATO GROSSO DO SUL","17502.9027589",12859,5656,5535,121,"3.2"
5007109,"RIBAS DO RIO PARDO","CENTRO-OESTE","MATO GROSSO DO SUL","17315.2826535",23150,10888,10469,419,"2.9"
5007208,"RIO BRILHANTE","CENTRO-OESTE","MATO GROSSO DO SUL","3983.5623685",37601,14825,14795,30,"2.8"
5007307,"RIO NEGRO","CENTRO-OESTE","MATO GROSSO DO SUL","1828.8002097",4841,2673,2662,11,"2.7"
5007406,"RIO VERDE DE MATO GROSSO","CENTRO-OESTE","MATO GROSSO DO SUL","8174.7841215",19818,9934,9855,79,"2.7"
5007505,"ROCHEDO","CENTRO-OESTE","MATO GROSSO DO SUL","1309.5735039",5199,2922,2919,3,"2.7"
5007554,"SANTA RITA DO PARDO","CENTRO-OESTE","MATO GROSSO DO SUL","6142.0013336",7027,4178,4169,9,"2.8"
5007695,"SÃO GABRIEL DO OESTE","CENTRO-OESTE","MATO GROSSO DO SUL","3850.6832064",29579,12330,12297,33,"2.8"
5007703,"SETE QUEDAS","CENTRO-OESTE","MATO GROSSO DO SUL","839.1172989",10994,3907,3905,2,"3"
5007802,"SELVÍRIA","CENTRO-OESTE","MATO GROSSO DO SUL","3254.9168936",8142,3834,3823,11,"2.7"
5007901,"SIDROLÂNDIA","CENTRO-OESTE","MATO GROSSO DO SUL","5265.6953958",47118,20027,19977,50,"2.8"
5007935,"SONORA","CENTRO-OESTE","MATO GROSSO DO SUL","4185.5283319",14516,6790,6759,31,"2.8"
5007950,"TACURU","CENTRO-OESTE","MATO GROSSO DO SUL","1784.2069964",10808,3800,3795,5,"3.3"
5007976,"TAQUARUSSU","CENTRO-OESTE","MATO GROSSO DO SUL","1052.2316352",3625,1889,1888,1,"2.6"
5008008,"TERENOS","CENTRO-OESTE","MATO GROSSO DO SUL","2845.6525011",17652,9007,8990,17,"2.7"
5008305,"TRÊS LAGOAS","CENTRO-OESTE","MATO GROSSO DO SUL","10217.0713551",132152,59627,59517,110,"2.7"
5008404,"VICENTINA","CENTRO-OESTE","MATO GROSSO DO SUL","312.4357523",6336,2992,2989,3,"2.6"
5100102,"ACORIZAL","CENTRO-OESTE","MATO GROSSO","850.7629718",5014,3097,3093,4,"2.8"
5100201,"ÁGUA BOA","CENTRO-OESTE","MATO GROSSO","7549.3082069",29219,12037,11948,89,"2.8"
5100250,"ALTA FLORESTA","CENTRO-OESTE","MATO GROSSO","8955.4103455",58613,24514,24486,28,"2.8"
5100300,"ALTO ARAGUAIA","CENTRO-OESTE","MATO GROSSO","5402.3080212",17193,7656,7638,18,"2.6"
5100359,"ALTO BOA VISTA","CENTRO-OESTE","MATO GROSSO","2248.4141845",5715,2146,2136,10,"3.2"
5100409,"ALTO GARÇAS","CENTRO-OESTE","MATO GROSSO","3858.1529741",13052,5264,5146,118,"2.8"
5100508,"ALTO PARAGUAI","CENTRO-OESTE","MATO GROSSO","1847.3538537",8009,3909,3900,9,"2.7"
5100607,"ALTO TAQUARI","CENTRO-OESTE","MATO GROSSO","1436.5821702",10904,4166,4147,19,"2.8"
5100805,"APIACÁS","CENTRO-OESTE","MATO GROSSO","20489.0244228",8590,3777,3734,43,"3"
5101001,"ARAGUAIANA","CENTRO-OESTE","MATO GROSSO","6380.7004686",3795,2490,2479,11,"2.6"
5101209,"ARAGUAINHA","CENTRO-OESTE","MATO GROSSO","675.23086",1010,613,606,7,"2.5"
5101258,"ARAPUTANGA","CENTRO-OESTE","MATO GROSSO","1639.7327324",14786,6658,6643,15,"2.7"
5101308,"ARENÁPOLIS","CENTRO-OESTE","MATO GROSSO","417.3373527",10576,4595,4591,4,"2.8"
5101407,"ARIPUANÃ","CENTRO-OESTE","MATO GROSSO","24678.1352426",24626,10303,10221,82,"3.1"
5101605,"BARÃO DE MELGAÇO","CENTRO-OESTE","MATO GROSSO","11374.8724407",7253,4572,4530,42,"3"
5101704,"BARRA DO BUGRES","CENTRO-OESTE","MATO GROSSO","5976.8645149",29403,13634,13609,25,"2.8"
5101803,"BARRA DO GARÇAS","CENTRO-OESTE","MATO GROSSO","8363.1494319",69210,31896,31831,65,"2.7"
5101852,"BOM JESUS DO ARAGUAIA","CENTRO-OESTE","MATO GROSSO","4266.6361943",7280,3424,3381,43,"2.9"
5101902,"BRASNORTE","CENTRO-OESTE","MATO GROSSO","15968.3552463",17004,7298,7222,76,"2.9"
5102504,"CÁCERES","CENTRO-OESTE","MATO GROSSO","24499.921551",89681,39844,39688,156,"2.9"
5102603,"CAMPINÁPOLIS","CENTRO-OESTE","MATO GROSSO","5978.9852647",15347,4655,4649,6,"4.1"
5102637,"CAMPO NOVO DO PARECIS","CENTRO-OESTE","MATO GROSSO","9428.5854396",45899,16855,16581,274,"3"
5102678,"CAMPO VERDE","CENTRO-OESTE","MATO GROSSO","4770.6311775",44585,17442,17357,85,"2.9"
5102686,"CAMPOS DE JÚLIO","CENTRO-OESTE","MATO GROSSO","6792.8083325",8822,3595,3486,109,"3"
5102694,"CANABRAVA DO NORTE","CENTRO-OESTE","MATO GROSSO","3449.037076",4485,2171,2164,7,"2.8"
5102702,"CANARANA","CENTRO-OESTE","MATO GROSSO","10855.1806593",25858,10048,10025,23,"2.9"
5102793,"CARLINDA","CENTRO-OESTE","MATO GROSSO","2421.7875657",10332,5102,5097,5,"2.7"
5102850,"CASTANHEIRA","CENTRO-OESTE","MATO GROSSO","3713.4655514",7506,3711,3693,18,"2.7"
5103007,"CHAPADA DOS GUIMARÃES","CENTRO-OESTE","MATO GROSSO","6603.2519443",18990,13205,13139,66,"2.7"
5103056,"CLÁUDIA","CENTRO-OESTE","MATO GROSSO","3843.561322",9593,4588,4578,10,"2.8"
5103106,"COCALINHO","CENTRO-OESTE","MATO GROSSO","16563.1356226",6220,3939,3886,53,"2.7"
5103205,"COLÍDER","CENTRO-OESTE","MATO GROSSO","3112.0907537",31370,13835,13816,19,"2.7"
5103254,"COLNIZA","CENTRO-OESTE","MATO GROSSO","27960.2371608",25766,11944,11927,17,"2.9"
5103304,"COMODORO","CENTRO-OESTE","MATO GROSSO","21485.0179988",18238,8751,8731,20,"2.8"
5103353,"CONFRESA","CENTRO-OESTE","MATO GROSSO","5802.3027959",35075,14369,14328,41,"2.9"
5103361,"CONQUISTA D'OESTE","CENTRO-OESTE","MATO GROSSO","2684.675997",3760,1652,1635,17,"2.8"
5103379,"COTRIGUAÇU","CENTRO-OESTE","MATO GROSSO","9469.9571248",11011,5281,5258,23,"2.8"
5103403,"CUIABÁ","CENTRO-OESTE","MATO GROSSO","4327.4484375",650877,279657,279450,207,"2.8"
5103437,"CURVELÂNDIA","CENTRO-OESTE","MATO GROSSO","357.2120586",4903,2372,2370,2,"2.7"
5103452,"DENISE","CENTRO-OESTE","MATO GROSSO","1273.1779676",7014,3046,3044,2,"2.8"
5103502,"DIAMANTINO","CENTRO-OESTE","MATO GROSSO","8263.3969281",21941,9548,9419,129,"2.9"
5103601,"DOM AQUINO","CENTRO-OESTE","MATO GROSSO","2183.6030926",7872,4043,4015,28,"2.6"
5103700,"FELIZ NATAL","CENTRO-OESTE","MATO GROSSO","11661.5144457",10521,4125,4081,44,"3.1"
5103809,"FIGUEIRÓPOLIS D'OESTE","CENTRO-OESTE","MATO GROSSO","891.4479929",3187,1752,1751,1,"2.6"
5103858,"GAÚCHA DO NORTE","CENTRO-OESTE","MATO GROSSO","16908.3750854",8642,3434,3410,24,"3.2"
5103908,"GENERAL CARNEIRO","CENTRO-OESTE","MATO GROSSO","4514.9167709",6037,2751,2706,45,"3.2"
5103957,"GLÓRIA D'OESTE","CENTRO-OESTE","MATO GROSSO","833.1301934",2905,1656,1656,0,"2.6"
5104104,"GUARANTÃ DO NORTE","CENTRO-OESTE","MATO GROSSO","4725.2810317",31024,13148,13128,20,"2.8"
5104203,"GUIRATINGA","CENTRO-OESTE","MATO GROSSO","5043.899202",10966,5885,5845,40,"2.4"
5104500,"INDIAVAÍ","CENTRO-OESTE","MATO GROSSO","592.4948968",2213,1056,1054,2,"2.6"
5104526,"IPIRANGA DO NORTE","CENTRO-OESTE","MATO GROSSO","3422.0162439",7815,3088,3019,69,"3"
5104542,"ITANHANGÁ","CENTRO-OESTE","MATO GROSSO","2909.7453757",7539,2946,2927,19,"2.9"
5104559,"ITAÚBA","CENTRO-OESTE","MATO GROSSO","4521.7897531",5020,2264,2248,16,"2.9"
5104609,"ITIQUIRA","CENTRO-OESTE","MATO GROSSO","8698.8139407",12236,5869,5815,54,"2.8"
5104807,"JACIARA","CENTRO-OESTE","MATO GROSSO","2429.6776306",28569,12129,12071,58,"2.8"
5104906,"JANGADA","CENTRO-OESTE","MATO GROSSO","1114.3019866",7426,3149,3147,2,"2.9"
5105002,"JAURU","CENTRO-OESTE","MATO GROSSO","1345.4111151",8367,4165,4159,6,"2.7"
5105101,"JUARA","CENTRO-OESTE","MATO GROSSO","22632.7132157",34906,15842,15685,157,"2.9"
5105150,"JUÍNA","CENTRO-OESTE","MATO GROSSO","26397.1725638",45869,20336,20270,66,"2.7"
5105176,"JURUENA","CENTRO-OESTE","MATO GROSSO","3207.8374261",10213,4379,4376,3,"2.8"
5105200,"JUSCIMEIRA","CENTRO-OESTE","MATO GROSSO","2291.3067765",11480,6623,6613,10,"2.6"
5105234,"LAMBARI D'OESTE","CENTRO-OESTE","MATO GROSSO","1810.462808",4790,2374,2340,34,"2.8"
5105259,"LUCAS DO RIO VERDE","CENTRO-OESTE","MATO GROSSO","3674.5960122",83798,29669,29544,125,"3"
5105309,"LUCIARA","CENTRO-OESTE","MATO GROSSO","4282.7330399",2509,1184,1184,0,"3"
5105507,"VILA BELA DA SANTÍSSIMA TRINDADE","CENTRO-OESTE","MATO GROSSO","13484.7101355",16774,7172,7076,96,"3.1"
5105580,"MARCELÂNDIA","CENTRO-OESTE","MATO GROSSO","12285.4856574",11396,5134,5073,61,"3"
5105606,"MATUPÁ","CENTRO-OESTE","MATO GROSSO","5228.2719932",20091,8017,7988,29,"2.9"
5105622,"MIRASSOL D'OESTE","CENTRO-OESTE","MATO GROSSO","1085.486238",26785,11726,11717,9,"2.7"
5105903,"NOBRES","CENTRO-OESTE","MATO GROSSO","3908.739245",15492,6968,6950,18,"2.9"
5106000,"NORTELÂNDIA","CENTRO-OESTE","MATO GROSSO","1336.7540031",5956,2796,2787,9,"2.7"
5106109,"NOSSA SENHORA DO LIVRAMENTO","CENTRO-OESTE","MATO GROSSO","5537.412738",12940,7787,7774,13,"2.8"
5106158,"NOVA BANDEIRANTES","CENTRO-OESTE","MATO GROSSO","9556.6606048",13635,6228,6212,16,"2.7"
5106174,"NOVA NAZARÉ","CENTRO-OESTE","MATO GROSSO","4034.539156",4200,1586,1569,17,"3.6"
5106182,"NOVA LACERDA","CENTRO-OESTE","MATO GROSSO","4780.4257763",6670,3068,3009,59,"2.8"
5106190,"NOVA SANTA HELENA","CENTRO-OESTE","MATO GROSSO","2385.6106764",4239,1951,1948,3,"2.8"
5106208,"NOVA BRASILÂNDIA","CENTRO-OESTE","MATO GROSSO","3290.0315347",3932,2091,2083,8,"2.5"
5106216,"NOVA CANAÃ DO NORTE","CENTRO-OESTE","MATO GROSSO","5953.0992859",11707,5709,5692,17,"2.7"
5106224,"NOVA MUTUM","CENTRO-OESTE","MATO GROSSO","9536.8143804",55839,20700,20505,195,"3.1"
5106232,"NOVA OLÍMPIA","CENTRO-OESTE","MATO GROSSO","1327.2661867",16352,6674,6669,5,"2.8"
5106240,"NOVA UBIRATÃ","CENTRO-OESTE","MATO GROSSO","12460.7354475",11530,5112,4997,115,"3.1"
5106257,"NOVA XAVANTINA","CENTRO-OESTE","MATO GROSSO","5491.9719641",24345,11043,10999,44,"2.6"
5106265,"NOVO MUNDO","CENTRO-OESTE","MATO GROSSO","5800.7586874",6520,3401,3373,28,"2.9"
5106273,"NOVO HORIZONTE DO NORTE","CENTRO-OESTE","MATO GROSSO","920.0483869",3349,1769,1767,2,"2.7"
5106281,"NOVO SÃO JOAQUIM","CENTRO-OESTE","MATO GROSSO","5225.5954348",6919,3719,3668,51,"2.7"
5106299,"PARANAÍTA","CENTRO-OESTE","MATO GROSSO","4814.1488093",11671,5257,5239,18,"2.8"
5106307,"PARANATINGA","CENTRO-OESTE","MATO GROSSO","24166.6323961",26423,10579,10470,109,"2.9"
5106315,"NOVO SANTO ANTÔNIO","CENTRO-OESTE","MATO GROSSO","4394.7796396",2015,1079,1079,0,"2.7"
5106372,"PEDRA PRETA","CENTRO-OESTE","MATO GROSSO","3841.6718415",18066,9018,8914,104,"2.7"
5106422,"PEIXOTO DE AZEVEDO","CENTRO-OESTE","MATO GROSSO","14433.775205",32714,13073,13006,67,"3"
5106455,"PLANALTO DA SERRA","CENTRO-OESTE","MATO GROSSO","2437.5899339",3166,1557,1553,4,"2.8"
5106505,"POCONÉ","CENTRO-OESTE","MATO GROSSO","17152.3468329",31217,14280,14237,43,"3"
5106653,"PONTAL DO ARAGUAIA","CENTRO-OESTE","MATO GROSSO","2742.4819081",6932,3322,3315,7,"2.6"
5106703,"PONTE BRANCA","CENTRO-OESTE","MATO GROSSO","701.1384816",2008,1111,1107,4,"2.4"
5106752,"PONTES E LACERDA","CENTRO-OESTE","MATO GROSSO","8545.2918596",52018,20799,20755,44,"2.8"
5106778,"PORTO ALEGRE DO NORTE","CENTRO-OESTE","MATO GROSSO","3971.7320357",12127,4692,4657,35,"3"
5106802,"PORTO DOS GAÚCHOS","CENTRO-OESTE","MATO GROSSO","6846.6678713",5593,2632,2610,22,"2.7"
5106828,"PORTO ESPERIDIÃO","CENTRO-OESTE","MATO GROSSO","5835.2777368",10204,5062,5009,53,"2.9"
5106851,"PORTO ESTRELA","CENTRO-OESTE","MATO GROSSO","2045.4669531",3224,1751,1751,0,"2.7"
5107008,"POXORÉU","CENTRO-OESTE","MATO GROSSO","6915.2978009",23283,11361,11316,45,"2.8"
5107040,"PRIMAVERA DO LESTE","CENTRO-OESTE","MATO GROSSO","5470.3828926",85146,31934,31756,178,"2.9"
5107065,"QUERÊNCIA","CENTRO-OESTE","MATO GROSSO","17799.9885692",26769,9674,9597,77,"3.1"
5107107,"SÃO JOSÉ DOS QUATRO MARCOS","CENTRO-OESTE","MATO GROSSO","1282.7626178",17849,8395,8389,6,"2.6"
5107156,"RESERVA DO CABAÇAL","CENTRO-OESTE","MATO GROSSO","1331.6770484",2122,1086,1084,2,"2.5"
5107180,"RIBEIRÃO CASCALHEIRA","CENTRO-OESTE","MATO GROSSO","11354.5547187",10089,4644,4605,39,"2.9"
5107198,"RIBEIRÃOZINHO","CENTRO-OESTE","MATO GROSSO","624.9966155",2593,1234,1219,15,"2.6"
5107206,"RIO BRANCO","CENTRO-OESTE","MATO GROSSO","539.2868233",4535,2227,2222,5,"2.6"
5107248,"SANTA CARMEM","CENTRO-OESTE","MATO GROSSO","3812.0902771",5374,2161,2136,25,"3.1"
5107263,"SANTO AFONSO","CENTRO-OESTE","MATO GROSSO","1166.3815988",2519,1464,1460,4,"2.6"
5107297,"SÃO JOSÉ DO POVO","CENTRO-OESTE","MATO GROSSO","489.7370477",2875,1679,1679,0,"2.5"
5107305,"SÃO JOSÉ DO RIO CLARO","CENTRO-OESTE","MATO GROSSO","4525.3040748",14911,6377,6292,85,"2.8"
5203104,"BALIZA","CENTRO-OESTE","GOIÁS","1780.1726528",3351,1905,1899,6,"2.6"
5107354,"SÃO JOSÉ DO XINGU","CENTRO-OESTE","MATO GROSSO","7465.562522",5964,2696,2672,24,"3.1"
5107404,"SÃO PEDRO DA CIPA","CENTRO-OESTE","MATO GROSSO","344.3300921",4191,1834,1828,6,"2.8"
5107578,"RONDOLÂNDIA","CENTRO-OESTE","MATO GROSSO","12658.3415986",3505,1539,1501,38,"3.2"
5107602,"RONDONÓPOLIS","CENTRO-OESTE","MATO GROSSO","4824.0203137",244911,105400,105273,127,"2.8"
5107701,"ROSÁRIO OESTE","CENTRO-OESTE","MATO GROSSO","7339.4432329",15453,7840,7819,21,"2.8"
5107743,"SANTA CRUZ DO XINGU","CENTRO-OESTE","MATO GROSSO","5623.3902862",2661,1165,1155,10,"2.9"
5107750,"SALTO DO CÉU","CENTRO-OESTE","MATO GROSSO","1753.377749",3679,2095,2088,7,"2.6"
5107768,"SANTA RITA DO TRIVELATO","CENTRO-OESTE","MATO GROSSO","4747.0416043",3276,1366,1329,37,"3.1"
5107776,"SANTA TEREZINHA","CENTRO-OESTE","MATO GROSSO","6466.2232365",7596,3482,3471,11,"3.2"
5107792,"SANTO ANTÔNIO DO LESTE","CENTRO-OESTE","MATO GROSSO","3403.5929381",4099,1584,1539,45,"3.2"
5107800,"SANTO ANTÔNIO DE LEVERGER","CENTRO-OESTE","MATO GROSSO","9469.1393618",15246,8469,8449,20,"3"
5107859,"SÃO FÉLIX DO ARAGUAIA","CENTRO-OESTE","MATO GROSSO","16682.4730278",13621,5494,5366,128,"2.8"
5107875,"SAPEZAL","CENTRO-OESTE","MATO GROSSO","13614.5520313",28944,10984,10662,322,"3"
5107883,"SERRA NOVA DOURADA","CENTRO-OESTE","MATO GROSSO","1490.7932361",1800,885,885,0,"2.8"
5107909,"SINOP","CENTRO-OESTE","MATO GROSSO","3990.8698556",196312,77480,77373,107,"2.9"
5107925,"SORRISO","CENTRO-OESTE","MATO GROSSO","9293.6295281",110635,41141,40870,271,"3"
5107941,"TABAPORÃ","CENTRO-OESTE","MATO GROSSO","8439.0501635",9818,4486,4389,97,"2.9"
5107958,"TANGARÁ DA SERRA","CENTRO-OESTE","MATO GROSSO","11636.8250015",106434,42130,42059,71,"2.8"
5108006,"TAPURAH","CENTRO-OESTE","MATO GROSSO","4492.5393285",14370,5572,5441,131,"3.1"
5108055,"TERRA NOVA DO NORTE","CENTRO-OESTE","MATO GROSSO","2399.7366288",10616,4837,4826,11,"2.8"
5108105,"TESOURO","CENTRO-OESTE","MATO GROSSO","4244.0731744",3025,1740,1736,4,"2.6"
5108204,"TORIXORÉU","CENTRO-OESTE","MATO GROSSO","2398.3826278",4164,2404,2359,45,"2.4"
5108303,"UNIÃO DO SUL","CENTRO-OESTE","MATO GROSSO","4590.6281039",3838,1786,1765,21,"2.9"
5108352,"VALE DE SÃO DOMINGOS","CENTRO-OESTE","MATO GROSSO","1901.5447722",2904,1413,1412,1,"2.6"
5108402,"VÁRZEA GRANDE","CENTRO-OESTE","MATO GROSSO","724.278871",300078,126140,126055,85,"2.9"
5108501,"VERA","CENTRO-OESTE","MATO GROSSO","3058.3635563",12800,5050,4992,58,"3"
5108600,"VILA RICA","CENTRO-OESTE","MATO GROSSO","7436.3825627",19888,8441,8404,37,"2.9"
5108808,"NOVA GUARITA","CENTRO-OESTE","MATO GROSSO","1121.9275865",4590,2015,2015,0,"2.7"
5108857,"NOVA MARILÂNDIA","CENTRO-OESTE","MATO GROSSO","1905.7438549",3529,1638,1626,12,"2.8"
5108907,"NOVA MARINGÁ","CENTRO-OESTE","MATO GROSSO","11553.4786184",5846,2563,2464,99,"3"
5108956,"NOVA MONTE VERDE","CENTRO-OESTE","MATO GROSSO","5139.3066511",8313,4040,4030,10,"2.8"
5200050,"ABADIA DE GOIÁS","CENTRO-OESTE","GOIÁS","143.357335",19128,7866,7857,9,"3"
5200100,"ABADIÂNIA","CENTRO-OESTE","GOIÁS","1044.5549206",17232,10303,10246,57,"2.7"
5200134,"ACREÚNA","CENTRO-OESTE","GOIÁS","1566.7415748",21568,9355,9319,36,"2.7"
5200159,"ADELÂNDIA","CENTRO-OESTE","GOIÁS","115.385144",2297,1250,1249,1,"2.5"
5200175,"ÁGUA FRIA DE GOIÁS","CENTRO-OESTE","GOIÁS","2023.636421",4954,2808,2779,29,"2.7"
5200209,"ÁGUA LIMPA","CENTRO-OESTE","GOIÁS","458.8356248",1858,1182,1182,0,"2.5"
5200258,"ÁGUAS LINDAS DE GOIÁS","CENTRO-OESTE","GOIÁS","191.8168443",225693,90429,90403,26,"3"
5200308,"ALEXÂNIA","CENTRO-OESTE","GOIÁS","846.8756866",27008,16459,16446,13,"2.8"
5200506,"ALOÂNDIA","CENTRO-OESTE","GOIÁS","102.0943221",1973,1132,1132,0,"2.4"
5200555,"ALTO HORIZONTE","CENTRO-OESTE","GOIÁS","500.3416081",6072,2641,2629,12,"2.8"
5200605,"ALTO PARAÍSO DE GOIÁS","CENTRO-OESTE","GOIÁS","2594.9978319",10306,5431,5342,89,"2.8"
5200803,"ALVORADA DO NORTE","CENTRO-OESTE","GOIÁS","1268.3471683",8446,3764,3759,5,"2.9"
5200829,"AMARALINA","CENTRO-OESTE","GOIÁS","1343.7423234",3268,1837,1836,1,"2.5"
5200852,"AMERICANO DO BRASIL","CENTRO-OESTE","GOIÁS","133.8343304",5259,2810,2808,2,"2.5"
5200902,"AMORINÓPOLIS","CENTRO-OESTE","GOIÁS","406.930086",3007,1864,1859,5,"2.4"
5201108,"ANÁPOLIS","CENTRO-OESTE","GOIÁS","935.6716651",398869,171214,171050,164,"2.8"
5201207,"ANHANGUERA","CENTRO-OESTE","GOIÁS","55.568567",924,518,515,3,"2.6"
5201306,"ANICUNS","CENTRO-OESTE","GOIÁS","976.0378118",18503,9471,9464,7,"2.6"
5201405,"APARECIDA DE GOIÂNIA","CENTRO-OESTE","GOIÁS","279.9537778",527796,216870,216800,70,"2.8"
5201454,"APARECIDA DO RIO DOCE","CENTRO-OESTE","GOIÁS","603.2543324",2907,1419,1412,7,"2.6"
5201504,"APORÉ","CENTRO-OESTE","GOIÁS","2899.2366135",4325,2202,2184,18,"2.8"
5201603,"ARAÇU","CENTRO-OESTE","GOIÁS","149.7760029",3799,2057,2056,1,"2.5"
5201702,"ARAGARÇAS","CENTRO-OESTE","GOIÁS","661.6770863",18390,8080,8067,13,"2.7"
5201801,"ARAGOIÂNIA","CENTRO-OESTE","GOIÁS","218.1253963",11890,6322,6321,1,"2.5"
5202155,"ARAGUAPAZ","CENTRO-OESTE","GOIÁS","2188.0998364",7153,3725,3719,6,"2.6"
5202353,"ARENÓPOLIS","CENTRO-OESTE","GOIÁS","1075.5350388",2946,1848,1846,2,"2.4"
5202502,"ARUANÃ","CENTRO-OESTE","GOIÁS","3054.7726043",8300,5483,5434,49,"2.7"
5202601,"AURILÂNDIA","CENTRO-OESTE","GOIÁS","565.513607",3284,1968,1964,4,"2.4"
5202809,"AVELINÓPOLIS","CENTRO-OESTE","GOIÁS","170.2276479",2868,1457,1456,1,"2.6"
5203203,"BARRO ALTO","CENTRO-OESTE","GOIÁS","1080.2678469",10371,4403,4392,11,"2.8"
5203302,"BELA VISTA DE GOIÁS","CENTRO-OESTE","GOIÁS","1274.0336766",34445,16311,16287,24,"2.7"
5203401,"BOM JARDIM DE GOIÁS","CENTRO-OESTE","GOIÁS","1901.1365163",7826,4192,4185,7,"2.5"
5203500,"BOM JESUS DE GOIÁS","CENTRO-OESTE","GOIÁS","1405.6050555",23958,9982,9964,18,"2.8"
5203559,"BONFINÓPOLIS","CENTRO-OESTE","GOIÁS","121.9147959",10296,4808,4803,5,"2.7"
5203575,"BONÓPOLIS","CENTRO-OESTE","GOIÁS","1635.3190807",3299,1594,1590,4,"2.6"
5203609,"BRAZABRANTES","CENTRO-OESTE","GOIÁS","125.3259952",3992,2087,2083,4,"2.6"
5203807,"BRITÂNIA","CENTRO-OESTE","GOIÁS","1458.4594097",5695,3407,3393,14,"2.6"
5203906,"BURITI ALEGRE","CENTRO-OESTE","GOIÁS","901.9318499",10495,5993,5987,6,"2.5"
5203939,"BURITI DE GOIÁS","CENTRO-OESTE","GOIÁS","202.5760833",2732,1456,1455,1,"2.5"
5203962,"BURITINÓPOLIS","CENTRO-OESTE","GOIÁS","246.0753706",3145,1492,1491,1,"2.8"
5204003,"CABECEIRAS","CENTRO-OESTE","GOIÁS","1126.4339865",7560,3540,3531,9,"2.8"
5204102,"CACHOEIRA ALTA","CENTRO-OESTE","GOIÁS","1657.2255972",11513,5793,5771,22,"2.6"
5204201,"CACHOEIRA DE GOIÁS","CENTRO-OESTE","GOIÁS","424.4897121",1405,889,889,0,"2.4"
5204250,"CACHOEIRA DOURADA","CENTRO-OESTE","GOIÁS","528.2812211",7782,4037,4028,9,"2.6"
5204300,"CAÇU","CENTRO-OESTE","GOIÁS","2254.3403706",13774,6793,6776,17,"2.6"
5204409,"CAIAPÔNIA","CENTRO-OESTE","GOIÁS","8627.9609146",16513,8462,8415,47,"2.6"
5204508,"CALDAS NOVAS","CENTRO-OESTE","GOIÁS","1608.5226263",98622,69298,68905,393,"2.7"
5204557,"CALDAZINHA","CENTRO-OESTE","GOIÁS","251.7198771",4507,2657,2657,0,"2.6"
5204607,"CAMPESTRE DE GOIÁS","CENTRO-OESTE","GOIÁS","272.7338859",3755,1789,1789,0,"2.7"
5204656,"CAMPINAÇU","CENTRO-OESTE","GOIÁS","1978.3857798",3708,2168,2168,0,"2.6"
5204706,"CAMPINORTE","CENTRO-OESTE","GOIÁS","1064.5410043",12510,5533,5528,5,"2.7"
5204805,"CAMPO ALEGRE DE GOIÁS","CENTRO-OESTE","GOIÁS","2450.1113428",7422,3469,3430,39,"2.8"
5204854,"CAMPO LIMPO DE GOIÁS","CENTRO-OESTE","GOIÁS","156.1129552",8081,3308,3305,3,"3"
5204904,"CAMPOS BELOS","CENTRO-OESTE","GOIÁS","735.1261902",18108,8391,8376,15,"2.9"
5204953,"CAMPOS VERDES","CENTRO-OESTE","GOIÁS","443.1245057",4005,2240,2238,2,"2.7"
5205000,"CARMO DO RIO VERDE","CENTRO-OESTE","GOIÁS","419.8206776",9710,4538,4535,3,"2.6"
5205059,"CASTELÂNDIA","CENTRO-OESTE","GOIÁS","299.2284128",2985,1613,1610,3,"2.5"
5205109,"CATALÃO","CENTRO-OESTE","GOIÁS","3826.369992",114427,49953,49892,61,"2.7"
5205208,"CATURAÍ","CENTRO-OESTE","GOIÁS","205.0645826",5184,2731,2730,1,"2.6"
5205307,"CAVALCANTE","CENTRO-OESTE","GOIÁS","6948.7802816",9583,5706,5682,24,"2.7"
5205406,"CERES","CENTRO-OESTE","GOIÁS","213.0704052",22046,9984,9973,11,"2.6"
5205455,"CEZARINA","CENTRO-OESTE","GOIÁS","417.0802387",8090,4363,4357,6,"2.5"
5205471,"CHAPADÃO DO CÉU","CENTRO-OESTE","GOIÁS","2184.0765461",12870,4903,4848,55,"3"
5205497,"CIDADE OCIDENTAL","CENTRO-OESTE","GOIÁS","389.9852517",91767,38796,38786,10,"2.9"
5205513,"COCALZINHO DE GOIÁS","CENTRO-OESTE","GOIÁS","1785.3387594",25016,10861,10839,22,"2.8"
5205521,"COLINAS DO SUL","CENTRO-OESTE","GOIÁS","1707.5193559",4030,2267,2257,10,"2.7"
5205703,"CÓRREGO DO OURO","CENTRO-OESTE","GOIÁS","458.0771015",2454,1555,1555,0,"2.4"
5205802,"CORUMBÁ DE GOIÁS","CENTRO-OESTE","GOIÁS","1064.833452",10562,5416,5397,19,"2.8"
5205901,"CORUMBAÍBA","CENTRO-OESTE","GOIÁS","1864.2773079",9164,5077,5067,10,"2.6"
5206206,"CRISTALINA","CENTRO-OESTE","GOIÁS","6153.9214537",62337,25534,25427,107,"2.9"
5206305,"CRISTIANÓPOLIS","CENTRO-OESTE","GOIÁS","221.6237133",3504,1755,1749,6,"2.5"
5206404,"CRIXÁS","CENTRO-OESTE","GOIÁS","4673.0390467",17065,7941,7920,21,"2.7"
5206503,"CROMÍNIA","CENTRO-OESTE","GOIÁS","364.9179506",3883,2093,2090,3,"2.5"
5206602,"CUMARI","CENTRO-OESTE","GOIÁS","568.364768",2927,1830,1823,7,"2.5"
5206701,"DAMIANÓPOLIS","CENTRO-OESTE","GOIÁS","417.624953",3770,1975,1972,3,"2.8"
5206800,"DAMOLÂNDIA","CENTRO-OESTE","GOIÁS","86.0566441",2724,1437,1434,3,"2.5"
5206909,"DAVINÓPOLIS","CENTRO-OESTE","GOIÁS","482.857147",1902,1317,1316,1,"2.5"
5207105,"DIORAMA","CENTRO-OESTE","GOIÁS","685.3815878",2062,1174,1173,1,"2.5"
5207253,"DOVERLÂNDIA","CENTRO-OESTE","GOIÁS","3227.5583162",6956,3812,3798,14,"2.5"
5207352,"EDEALINA","CENTRO-OESTE","GOIÁS","598.2177579",4001,2281,2278,3,"2.4"
5207402,"EDÉIA","CENTRO-OESTE","GOIÁS","1469.0990613",11747,5582,5566,16,"2.7"
5207501,"ESTRELA DO NORTE","CENTRO-OESTE","GOIÁS","301.1386417",3205,1562,1561,1,"2.5"
5207535,"FAINA","CENTRO-OESTE","GOIÁS","1949.6849143",7070,3954,3949,5,"2.5"
5207600,"FAZENDA NOVA","CENTRO-OESTE","GOIÁS","1279.1065603",5877,3707,3702,5,"2.4"
5207808,"FIRMINÓPOLIS","CENTRO-OESTE","GOIÁS","422.3399991",10419,4870,4864,6,"2.6"
5207907,"FLORES DE GOIÁS","CENTRO-OESTE","GOIÁS","3695.106038",13744,5171,5142,29,"3.1"
5208004,"FORMOSA","CENTRO-OESTE","GOIÁS","5804.2924086",115901,50308,50256,52,"2.8"
5208103,"FORMOSO","CENTRO-OESTE","GOIÁS","843.4202738",4660,2410,2408,2,"2.6"
5208152,"GAMELEIRA DE GOIÁS","CENTRO-OESTE","GOIÁS","588.3278811",3456,2077,2075,2,"2.7"
5208301,"DIVINÓPOLIS DE GOIÁS","CENTRO-OESTE","GOIÁS","828.8737687",4457,2261,2261,0,"2.7"
5208400,"GOIANÁPOLIS","CENTRO-OESTE","GOIÁS","166.6416022",13967,5650,5643,7,"2.8"
5208509,"GOIANDIRA","CENTRO-OESTE","GOIÁS","569.9168242",4973,2721,2719,2,"2.6"
5208608,"GOIANÉSIA","CENTRO-OESTE","GOIÁS","1547.3192868",73707,30189,30162,27,"2.8"
5208707,"GOIÂNIA","CENTRO-OESTE","GOIÁS","729.2964012",1437366,655531,655185,346,"2.6"
5208806,"GOIANIRA","CENTRO-OESTE","GOIÁS","213.7724754",71916,29363,29353,10,"2.9"
5208905,"GOIÁS","CENTRO-OESTE","GOIÁS","3108.4227993",24071,14220,14190,30,"2.5"
5209101,"GOIATUBA","CENTRO-OESTE","GOIÁS","2479.5906294",35664,16696,16673,23,"2.6"
5209150,"GOUVELÂNDIA","CENTRO-OESTE","GOIÁS","827.3730636",4390,2353,2346,7,"2.6"
5209200,"GUAPÓ","CENTRO-OESTE","GOIÁS","514.1784047",19545,8973,8967,6,"2.7"
5209291,"GUARAÍTA","CENTRO-OESTE","GOIÁS","205.5331731",2188,1346,1346,0,"2.4"
5209408,"GUARANI DE GOIÁS","CENTRO-OESTE","GOIÁS","1221.0541232",4085,2090,2088,2,"2.8"
5209457,"GUARINOS","CENTRO-OESTE","GOIÁS","593.1883902",2161,1267,1266,1,"2.4"
5209606,"HEITORAÍ","CENTRO-OESTE","GOIÁS","228.6152074",3354,2721,2721,0,"2.5"
5209705,"HIDROLÂNDIA","CENTRO-OESTE","GOIÁS","952.1217679",27742,12199,12185,14,"2.8"
5209804,"HIDROLINA","CENTRO-OESTE","GOIÁS","583.7563712",3545,1806,1803,3,"2.6"
5209903,"IACIARA","CENTRO-OESTE","GOIÁS","1547.1834349",10584,4729,4717,12,"3"
5209937,"INACIOLÂNDIA","CENTRO-OESTE","GOIÁS","689.2009259",5954,2867,2854,13,"2.7"
5209952,"INDIARA","CENTRO-OESTE","GOIÁS","955.4186757",17061,7203,7199,4,"2.7"
5210000,"INHUMAS","CENTRO-OESTE","GOIÁS","614.8874232",52204,23718,23708,10,"2.7"
5210109,"IPAMERI","CENTRO-OESTE","GOIÁS","4382.8634278",25548,12563,12517,46,"2.6"
5210158,"IPIRANGA DE GOIÁS","CENTRO-OESTE","GOIÁS","244.2087312",2919,1572,1570,2,"2.5"
5210208,"IPORÁ","CENTRO-OESTE","GOIÁS","1027.2493559",35684,17243,17209,34,"2.5"
5210307,"ISRAELÂNDIA","CENTRO-OESTE","GOIÁS","579.1895932",2560,1457,1453,4,"2.4"
5210406,"ITABERAÍ","CENTRO-OESTE","GOIÁS","1461.9163397",44734,19479,19437,42,"2.8"
5210562,"ITAGUARI","CENTRO-OESTE","GOIÁS","142.6522145",4963,2391,2388,3,"2.5"
5210604,"ITAGUARU","CENTRO-OESTE","GOIÁS","241.0291127",4904,2607,2606,1,"2.5"
5210802,"ITAJÁ","CENTRO-OESTE","GOIÁS","2082.736505",4380,2362,2358,4,"2.5"
5210901,"ITAPACI","CENTRO-OESTE","GOIÁS","952.9976355",21087,9210,9205,5,"2.7"
5211008,"ITAPIRAPUÃ","CENTRO-OESTE","GOIÁS","2047.8735433",8007,4526,4525,1,"2.5"
5211206,"ITAPURANGA","CENTRO-OESTE","GOIÁS","1281.4042543",26113,13395,13387,8,"2.5"
5211305,"ITARUMÃ","CENTRO-OESTE","GOIÁS","3437.3671923",6101,3436,3412,24,"2.6"
5211404,"ITAUÇU","CENTRO-OESTE","GOIÁS","383.0655319",7736,3577,3574,3,"2.6"
5211503,"ITUMBIARA","CENTRO-OESTE","GOIÁS","2447.0140612",107970,47434,47364,70,"2.7"
5211602,"IVOLÂNDIA","CENTRO-OESTE","GOIÁS","1260.841083",2693,1719,1715,4,"2.5"
5211701,"JANDAIA","CENTRO-OESTE","GOIÁS","863.086542",6272,3457,3455,2,"2.5"
5211800,"JARAGUÁ","CENTRO-OESTE","GOIÁS","1848.9470075",45223,20647,20624,23,"2.7"
5211909,"JATAÍ","CENTRO-OESTE","GOIÁS","7178.7918253",105729,45373,45273,100,"2.7"
5212006,"JAUPACI","CENTRO-OESTE","GOIÁS","528.7830508",2924,1586,1585,1,"2.5"
5212055,"JESÚPOLIS","CENTRO-OESTE","GOIÁS","115.2106947",2123,1126,1126,0,"2.5"
5212105,"JOVIÂNIA","CENTRO-OESTE","GOIÁS","446.2583803",7159,3287,3283,4,"2.6"
5212204,"JUSSARA","CENTRO-OESTE","GOIÁS","4092.3394498",19620,10039,9988,51,"2.5"
5212253,"LAGOA SANTA","CENTRO-OESTE","GOIÁS","463.2892278",1390,868,854,14,"2.6"
5212303,"LEOPOLDO DE BULHÕES","CENTRO-OESTE","GOIÁS","476.1372806",8745,5485,5484,1,"2.7"
5212501,"LUZIÂNIA","CENTRO-OESTE","GOIÁS","3962.1070778",209129,92912,92825,87,"2.9"
5212600,"MAIRIPOTABA","CENTRO-OESTE","GOIÁS","468.0291158",2561,1659,1658,1,"2.4"
5212709,"MAMBAÍ","CENTRO-OESTE","GOIÁS","858.2698466",8124,3419,3418,1,"3.1"
5212808,"MARA ROSA","CENTRO-OESTE","GOIÁS","1695.4631832",10700,5250,5240,10,"2.6"
5212907,"MARZAGÃO","CENTRO-OESTE","GOIÁS","225.5175206",2758,1310,1309,1,"2.8"
5212956,"MATRINCHÃ","CENTRO-OESTE","GOIÁS","1150.5025103",4042,2365,2354,11,"2.6"
5213004,"MAURILÂNDIA","CENTRO-OESTE","GOIÁS","389.958648",10304,4538,4518,20,"2.7"
5213053,"MIMOSO DE GOIÁS","CENTRO-OESTE","GOIÁS","1380.7010371",2614,1573,1570,3,"2.7"
5213087,"MINAÇU","CENTRO-OESTE","GOIÁS","2854.1365795",27075,12840,12813,27,"2.7"
5213103,"MINEIROS","CENTRO-OESTE","GOIÁS","9042.8440576",70081,31624,31587,37,"2.8"
5213400,"MOIPORÁ","CENTRO-OESTE","GOIÁS","452.3136707",1685,1028,1027,1,"2.4"
5213509,"MONTE ALEGRE DE GOIÁS","CENTRO-OESTE","GOIÁS","3119.8601971",6692,3789,3786,3,"2.9"
5213707,"MONTES CLAROS DE GOIÁS","CENTRO-OESTE","GOIÁS","2900.3970907",8756,5553,5520,33,"2.5"
5213756,"MONTIVIDIU","CENTRO-OESTE","GOIÁS","1869.5805358",12521,5306,5231,75,"2.8"
5213772,"MONTIVIDIU DO NORTE","CENTRO-OESTE","GOIÁS","1337.2322531",3779,1944,1943,1,"2.5"
5213806,"MORRINHOS","CENTRO-OESTE","GOIÁS","2846.2986728",51351,23986,23966,20,"2.6"
5213855,"MORRO AGUDO DE GOIÁS","CENTRO-OESTE","GOIÁS","282.3327256",2456,1559,1559,0,"2.5"
5213905,"MOSSÂMEDES","CENTRO-OESTE","GOIÁS","684.8817507",4654,2681,2677,4,"2.5"
5214002,"MOZARLÂNDIA","CENTRO-OESTE","GOIÁS","1738.5164887",14750,6365,6343,22,"2.8"
5214051,"MUNDO NOVO","CENTRO-OESTE","GOIÁS","2141.533713",6189,2876,2861,15,"2.7"
5214101,"MUTUNÓPOLIS","CENTRO-OESTE","GOIÁS","955.0694431",3564,1987,1981,6,"2.6"
5214408,"NAZÁRIO","CENTRO-OESTE","GOIÁS","281.1466183",8189,3917,3915,2,"2.6"
5214507,"NERÓPOLIS","CENTRO-OESTE","GOIÁS","204.7129999",31932,12716,12706,10,"2.9"
5214606,"NIQUELÂNDIA","CENTRO-OESTE","GOIÁS","9846.2934019",34964,21601,21574,27,"2.6"
5214705,"NOVA AMÉRICA","CENTRO-OESTE","GOIÁS","209.4318105",2337,1097,1095,2,"2.6"
5214804,"NOVA AURORA","CENTRO-OESTE","GOIÁS","307.3347655",2101,1135,1133,2,"2.5"
5214838,"NOVA CRIXÁS","CENTRO-OESTE","GOIÁS","7308.6805338",12815,7880,7802,78,"2.7"
5214861,"NOVA GLÓRIA","CENTRO-OESTE","GOIÁS","411.7533724",8310,4301,4297,4,"2.5"
5214879,"NOVA IGUAÇU DE GOIÁS","CENTRO-OESTE","GOIÁS","625.6249952",3010,1467,1464,3,"2.7"
5214903,"NOVA ROMA","CENTRO-OESTE","GOIÁS","2136.725098",3076,1855,1849,6,"2.7"
5215009,"NOVA VENEZA","CENTRO-OESTE","GOIÁS","122.3542852",9481,4236,4235,1,"2.7"
5215207,"NOVO BRASIL","CENTRO-OESTE","GOIÁS","649.3493933",3527,2062,2061,1,"2.3"
5215231,"NOVO GAMA","CENTRO-OESTE","GOIÁS","192.2853405",103804,39592,39570,22,"3"
5215256,"NOVO PLANALTO","CENTRO-OESTE","GOIÁS","1254.4912487",3716,1818,1805,13,"2.6"
5215306,"ORIZONA","CENTRO-OESTE","GOIÁS","1971.2653213",16399,8235,8221,14,"2.6"
5215405,"OURO VERDE DE GOIÁS","CENTRO-OESTE","GOIÁS","208.8044599",4057,2173,2171,2,"2.7"
5215504,"OUVIDOR","CENTRO-OESTE","GOIÁS","411.3181901",7200,3773,3767,6,"2.7"
5215603,"PADRE BERNARDO","CENTRO-OESTE","GOIÁS","3142.6148715",34967,16439,16416,23,"2.9"
5215652,"PALESTINA DE GOIÁS","CENTRO-OESTE","GOIÁS","1318.0467675",3132,1786,1779,7,"2.6"
5215702,"PALMEIRAS DE GOIÁS","CENTRO-OESTE","GOIÁS","1537.1962041",31858,15080,15070,10,"2.7"
5215801,"PALMELO","CENTRO-OESTE","GOIÁS","59.8085921",2259,1198,1190,8,"2.5"
5215900,"PALMINÓPOLIS","CENTRO-OESTE","GOIÁS","393.3264135",3851,1971,1970,1,"2.5"
5216007,"PANAMÁ","CENTRO-OESTE","GOIÁS","432.2035626",2455,1433,1432,1,"2.5"
5216304,"PARANAIGUARA","CENTRO-OESTE","GOIÁS","1153.4145405",7607,4055,4045,10,"2.5"
5216403,"PARAÚNA","CENTRO-OESTE","GOIÁS","3786.5783345",10659,5336,5299,37,"2.6"
5216452,"PEROLÂNDIA","CENTRO-OESTE","GOIÁS","1033.6568808",2964,1346,1345,1,"2.8"
5216809,"PETROLINA DE GOIÁS","CENTRO-OESTE","GOIÁS","530.4897591",9573,4759,4757,2,"2.5"
5216908,"PILAR DE GOIÁS","CENTRO-OESTE","GOIÁS","906.048455",2328,1260,1259,1,"2.6"
5217104,"PIRACANJUBA","CENTRO-OESTE","GOIÁS","2374.2324763",24883,13719,13702,17,"2.5"
5217203,"PIRANHAS","CENTRO-OESTE","GOIÁS","2045.0881366",11712,5602,5588,14,"2.5"
5217302,"PIRENÓPOLIS","CENTRO-OESTE","GOIÁS","2200.3694206",26690,15028,14833,195,"2.7"
5217401,"PIRES DO RIO","CENTRO-OESTE","GOIÁS","1077.6414186",32373,14420,14396,24,"2.6"
5217609,"PLANALTINA","CENTRO-OESTE","GOIÁS","2558.9242803",105031,47272,47242,30,"3"
5217708,"PONTALINA","CENTRO-OESTE","GOIÁS","1434.2893316",18309,9010,9001,9,"2.5"
5218003,"PORANGATU","CENTRO-OESTE","GOIÁS","4825.2866288",44317,19420,19369,51,"2.7"
5218052,"PORTEIRÃO","CENTRO-OESTE","GOIÁS","606.2624842",4070,1719,1716,3,"2.7"
5218102,"PORTELÂNDIA","CENTRO-OESTE","GOIÁS","553.4106011",3280,1784,1783,1,"2.6"
5218300,"POSSE","CENTRO-OESTE","GOIÁS","2076.9903716",34914,14962,14928,34,"2.9"
5218391,"PROFESSOR JAMIL","CENTRO-OESTE","GOIÁS","356.2918227",3649,2276,2272,4,"2.5"
5218508,"QUIRINÓPOLIS","CENTRO-OESTE","GOIÁS","3786.0263119",48447,21155,21106,49,"2.7"
5218607,"RIALMA","CENTRO-OESTE","GOIÁS","268.290694",12165,5148,5140,8,"2.7"
5218706,"RIANÁPOLIS","CENTRO-OESTE","GOIÁS","157.3792867",3980,1899,1895,4,"2.5"
5218789,"RIO QUENTE","CENTRO-OESTE","GOIÁS","244.6552526",3864,4122,4109,13,"2.8"
5218805,"RIO VERDE","CENTRO-OESTE","GOIÁS","8374.2544485",225696,90664,90515,149,"2.8"
5218904,"RUBIATABA","CENTRO-OESTE","GOIÁS","750.6590827",19788,9163,9151,12,"2.6"
5219001,"SANCLERLÂNDIA","CENTRO-OESTE","GOIÁS","509.4016616",7918,4118,4114,4,"2.5"
5219100,"SANTA BÁRBARA DE GOIÁS","CENTRO-OESTE","GOIÁS","140.9574142",6149,2857,2857,0,"2.7"
5219209,"SANTA CRUZ DE GOIÁS","CENTRO-OESTE","GOIÁS","1109.0071372",3002,2037,2036,1,"2.4"
5219258,"SANTA FÉ DE GOIÁS","CENTRO-OESTE","GOIÁS","1164.1859578",4951,2444,2441,3,"2.7"
5219308,"SANTA HELENA DE GOIÁS","CENTRO-OESTE","GOIÁS","1142.3368657",38492,16440,16414,26,"2.7"
5219357,"SANTA ISABEL","CENTRO-OESTE","GOIÁS","812.7559928",3538,2110,2107,3,"2.5"
5219407,"SANTA RITA DO ARAGUAIA","CENTRO-OESTE","GOIÁS","1357.1969761",5924,3601,3595,6,"2.6"
5219456,"SANTA RITA DO NOVO DESTINO","CENTRO-OESTE","GOIÁS","970.448379",2689,1740,1740,0,"2.6"
5219506,"SANTA ROSA DE GOIÁS","CENTRO-OESTE","GOIÁS","166.4402499",2820,1540,1537,3,"2.6"
5219605,"SANTA TEREZA DE GOIÁS","CENTRO-OESTE","GOIÁS","789.5436137",3293,1846,1840,6,"2.5"
5219704,"SANTA TEREZINHA DE GOIÁS","CENTRO-OESTE","GOIÁS","1206.599533",10645,4905,4894,11,"2.7"
5219712,"SANTO ANTÔNIO DA BARRA","CENTRO-OESTE","GOIÁS","450.3360266",4267,2083,2080,3,"2.7"
5219738,"SANTO ANTÔNIO DE GOIÁS","CENTRO-OESTE","GOIÁS","135.0219315",7386,3322,3322,0,"2.8"
5219753,"SANTO ANTÔNIO DO DESCOBERTO","CENTRO-OESTE","GOIÁS","943.9480782",72127,30420,30403,17,"3"
5219803,"SÃO DOMINGOS","CENTRO-OESTE","GOIÁS","3335.998781",9711,4856,4843,13,"2.8"
5219902,"SÃO FRANCISCO DE GOIÁS","CENTRO-OESTE","GOIÁS","416.5352188",6378,3206,3203,3,"2.7"
5220009,"SÃO JOÃO D'ALIANÇA","CENTRO-OESTE","GOIÁS","3334.4553142",14041,5247,5213,34,"3.2"
5220058,"SÃO JOÃO DA PARAÚNA","CENTRO-OESTE","GOIÁS","286.9786711",1774,903,903,0,"2.5"
5220108,"SÃO LUÍS DE MONTES BELOS","CENTRO-OESTE","GOIÁS","829.6204923",33852,16045,16028,17,"2.6"
5220157,"SÃO LUIZ DO NORTE","CENTRO-OESTE","GOIÁS","583.8320922",4837,2280,2271,9,"2.7"
5220207,"SÃO MIGUEL DO ARAGUAIA","CENTRO-OESTE","GOIÁS","6150.1788798",21900,10684,10626,58,"2.6"
5220264,"SÃO MIGUEL DO PASSA QUATRO","CENTRO-OESTE","GOIÁS","537.3466018",4464,2206,2203,3,"2.6"
5220280,"SÃO PATRÍCIO","CENTRO-OESTE","GOIÁS","172.7628552",2143,1114,1112,2,"2.6"
5220405,"SÃO SIMÃO","CENTRO-OESTE","GOIÁS","415.0147167",17020,8262,8244,18,"2.5"
5220454,"SENADOR CANEDO","CENTRO-OESTE","GOIÁS","247.0048218",155635,59910,59897,13,"3"
5220504,"SERRANÓPOLIS","CENTRO-OESTE","GOIÁS","5521.7744056",8027,4278,4237,41,"2.7"
5220603,"SILVÂNIA","CENTRO-OESTE","GOIÁS","2349.9240804",22245,11743,11727,16,"2.7"
5220686,"SIMOLÂNDIA","CENTRO-OESTE","GOIÁS","346.8111678",5742,2571,2563,8,"2.9"
5220702,"SÍTIO D'ABADIA","CENTRO-OESTE","GOIÁS","1611.8512509",2927,1586,1586,0,"2.9"
5221007,"TAQUARAL DE GOIÁS","CENTRO-OESTE","GOIÁS","205.6646029",4026,2071,2069,2,"2.5"
5221080,"TERESINA DE GOIÁS","CENTRO-OESTE","GOIÁS","784.7929127",2701,1349,1344,5,"2.9"
5221197,"TEREZÓPOLIS DE GOIÁS","CENTRO-OESTE","GOIÁS","107.4068728",7944,3544,3540,4,"2.8"
5221304,"TRÊS RANCHOS","CENTRO-OESTE","GOIÁS","284.0341014",2921,2809,2715,94,"2.6"
5221403,"TRINDADE","CENTRO-OESTE","GOIÁS","712.6902146",142431,61811,61762,49,"2.8"
5221452,"TROMBAS","CENTRO-OESTE","GOIÁS","802.9052604",3120,1654,1652,2,"2.5"
5221502,"TURVÂNIA","CENTRO-OESTE","GOIÁS","482.3169929",4480,2340,2338,2,"2.5"
5221551,"TURVELÂNDIA","CENTRO-OESTE","GOIÁS","935.6586732",4985,2383,2380,3,"2.8"
5221577,"UIRAPURU","CENTRO-OESTE","GOIÁS","1154.3052282",2798,1494,1485,9,"2.6"
5221601,"URUAÇU","CENTRO-OESTE","GOIÁS","2142.4839713",42546,20432,20408,24,"2.7"
5221700,"URUANA","CENTRO-OESTE","GOIÁS","522.903739",13729,6519,6511,8,"2.6"
5221809,"URUTAÍ","CENTRO-OESTE","GOIÁS","623.8214288",3553,2212,2203,9,"2.6"
5221858,"VALPARAÍSO DE GOIÁS","CENTRO-OESTE","GOIÁS","61.4877674",198861,87494,87474,20,"2.8"
5221908,"VARJÃO","CENTRO-OESTE","GOIÁS","517.4022622",3716,2409,2408,1,"2.4"
5222005,"VIANÓPOLIS","CENTRO-OESTE","GOIÁS","954.1145323",14956,6815,6801,14,"2.7"
5222054,"VICENTINÓPOLIS","CENTRO-OESTE","GOIÁS","733.794201",8768,3810,3797,13,"2.8"
5222203,"VILA BOA","CENTRO-OESTE","GOIÁS","1052.59332",4215,1953,1944,9,"2.9"
5222302,"VILA PROPÍCIO","CENTRO-OESTE","GOIÁS","2181.5925482",5815,3212,3207,5,"2.7"
5300108,"BRASÍLIA","CENTRO-OESTE","DISTRITO FEDERAL","5760.782505",2817381,1172689,1172001,688,"2.8"
